,Zeit,FahrradbrueckeFahrradbruecke,FahrradbrueckeFahrradbruecke stadteinwärts Fahrräder,FahrradbrueckeFahrradbruecke stadtauswärts Fahrräder,Symbol Wetter,Temperatur (°C),Gefühlte Temperatur (°C),Regen (mm),
,2021-01-01 00:00:00,4,2,2,Leichter Schneefall,-1,-3,0,
,2021-01-01 01:00:00,9,4,5,Leichter Schneefall,-1,-2,0,
,2021-01-01 02:00:00,8,7,1,Leicht bewölkt,-1,-2,0,
,2021-01-01 03:00:00,6,1,5,Leicht bewölkt,-1,-2,0,
,2021-01-01 04:00:00,9,5,4,Leicht bewölkt,-1,-2,0,
,2021-01-01 05:00:00,32,15,17,Mäßiger Schneefall,-1,-2,0,
,2021-01-01 06:00:00,14,9,5,Mäßiger Schneefall,-1,-2,0,
,2021-01-01 07:00:00,11,6,5,Mäßiger Schneefall,-1,-1,0,
,2021-01-01 08:00:00,14,7,7,Bedeckt,0,-1,0,
,2021-01-01 09:00:00,37,18,19,Bedeckt,0,0,0,
,2021-01-01 10:00:00,52,24,28,Bedeckt,1,1,0,
,2021-01-01 11:00:00,88,44,44,Bedeckt,2,1,0,
,2021-01-01 12:00:00,104,43,61,Bedeckt,2,2,0,
,2021-01-01 13:00:00,124,41,83,Bedeckt,2,1,0,
,2021-01-01 14:00:00,184,96,88,Leicht bewölkt,2,0,0,
,2021-01-01 15:00:00,189,92,97,Leicht bewölkt,1,0,0,
,2021-01-01 16:00:00,151,68,83,Leicht bewölkt,1,-1,0,
,2021-01-01 17:00:00,120,61,59,Leicht bewölkt,0,-2,0,
,2021-01-01 18:00:00,77,39,38,Leicht bewölkt,-1,-3,0,
,2021-01-01 19:00:00,116,64,52,Leicht bewölkt,-2,-4,0,
,2021-01-01 20:00:00,25,7,18,Leicht bewölkt,-4,-5,0,
,2021-01-01 21:00:00,13,5,8,Leicht bewölkt,-5,-6,0,
,2021-01-01 22:00:00,5,3,2,Leicht bewölkt,-4,-5,0,
,2021-01-01 23:00:00,6,3,3,Bedeckt,-2,-4,0,
,2021-01-02 00:00:00,4,3,1,Bedeckt,-1,-4,0,
,2021-01-02 01:00:00,2,2,0,Bedeckt,-1,-4,0,
,2021-01-02 02:00:00,3,3,0,Bedeckt,-1,-4,0,
,2021-01-02 03:00:00,1,0,1,Bedeckt,-1,-4,0,
,2021-01-02 04:00:00,3,1,2,Bedeckt,-1,-4,0,
,2021-01-02 05:00:00,15,10,5,Leicht bewölkt,-1,-5,0,
,2021-01-02 06:00:00,20,12,8,Leicht bewölkt,-2,-5,0,
,2021-01-02 07:00:00,26,20,6,Leicht bewölkt,-1,-5,0,
,2021-01-02 08:00:00,51,32,19,Bewölkt,-1,-5,0,
,2021-01-02 09:00:00,102,55,47,Bewölkt,-1,-5,0,
,2021-01-02 10:00:00,202,93,109,Bewölkt,0,-4,0,
,2021-01-02 11:00:00,243,115,128,Leicht bewölkt,0,-3,0,
,2021-01-02 12:00:00,262,135,127,Leicht bewölkt,1,-3,0,
,2021-01-02 13:00:00,213,86,127,Leicht bewölkt,1,-3,0,
,2021-01-02 14:00:00,258,121,137,Leicht bewölkt,1,-3,0,
,2021-01-02 15:00:00,237,112,125,Leicht bewölkt,1,-3,0,
,2021-01-02 16:00:00,215,117,98,Leicht bewölkt,1,-3,0,
,2021-01-02 17:00:00,166,65,101,Leicht bewölkt,1,-3,0,
,2021-01-02 18:00:00,128,71,57,Leicht bewölkt,0,-3,0,
,2021-01-02 19:00:00,138,76,62,Leicht bewölkt,0,-2,0,
,2021-01-02 20:00:00,48,25,23,Bedeckt,0,-2,0,
,2021-01-02 21:00:00,17,7,10,Bedeckt,0,-1,0,
,2021-01-02 22:00:00,10,4,6,Bedeckt,0,-2,0,
,2021-01-02 23:00:00,11,7,4,Leichter Schneefall,-1,-2,0,
,2021-01-03 00:00:00,6,3,3,Leichter Schneefall,-2,-3,0,
,2021-01-03 01:00:00,1,1,0,Leichter Schneefall,-1,-2,0,
,2021-01-03 02:00:00,0,0,0,Mäßiger Schneefall,-1,-2,0,
,2021-01-03 03:00:00,1,1,0,Mäßiger Schneefall,0,-2,0,
,2021-01-03 04:00:00,2,0,2,Mäßiger Schneefall,0,-2,0,
,2021-01-03 05:00:00,7,3,4,Mäßiger Schneefall,0,-2,0,
,2021-01-03 06:00:00,13,9,4,Mäßiger Schneefall,0,-2,0,
,2021-01-03 07:00:00,12,6,6,Mäßiger Schneefall,0,-1,0,
,2021-01-03 08:00:00,33,15,18,Leichter Nebel,0,-1,0,
,2021-01-03 09:00:00,64,34,30,Leichter Nebel,0,-1,0,
,2021-01-03 10:00:00,108,47,61,Leichter Nebel,1,0,0,
,2021-01-03 11:00:00,116,47,69,Mäßiger Schneefall,1,0,0,
,2021-01-03 12:00:00,190,99,91,Mäßiger Schneefall,2,1,0,
,2021-01-03 13:00:00,179,76,103,Mäßiger Schneefall,2,1,0,
,2021-01-03 14:00:00,204,90,114,Bedeckt,2,1,0,
,2021-01-03 15:00:00,180,79,101,Bedeckt,2,1,0,
,2021-01-03 16:00:00,209,114,95,Bedeckt,1,1,0,
,2021-01-03 17:00:00,178,91,87,Leichter Schneefall,1,1,0,
,2021-01-03 18:00:00,126,62,64,Leichter Schneefall,1,0,0,
,2021-01-03 19:00:00,130,69,61,Leichter Schneefall,1,0,0,
,2021-01-03 20:00:00,52,30,22,Bedeckt,0,0,0,
,2021-01-03 21:00:00,18,7,11,Bedeckt,0,0,0,
,2021-01-03 22:00:00,9,4,5,Bedeckt,0,0,0,
,2021-01-03 23:00:00,6,2,4,Bedeckt,0,0,0,
,2021-01-04 00:00:00,5,3,2,Bedeckt,0,0,0,
,2021-01-04 01:00:00,1,0,1,Bedeckt,-1,-1,0,
,2021-01-04 02:00:00,1,1,0,Leicht bewölkt,-1,-1,0,
,2021-01-04 03:00:00,2,0,2,Leicht bewölkt,-2,-2,0,
,2021-01-04 04:00:00,7,4,3,Leicht bewölkt,-2,-2,0,
,2021-01-04 05:00:00,22,15,7,Leicht bewölkt,-2,-2,0,
,2021-01-04 06:00:00,99,64,35,Leicht bewölkt,-3,-3,0,
,2021-01-04 07:00:00,173,109,64,Leicht bewölkt,-2,-2,0,
,2021-01-04 08:00:00,208,136,72,Leicht bewölkt,-1,-1,0,
,2021-01-04 09:00:00,203,113,90,Leicht bewölkt,-1,-1,0,
,2021-01-04 10:00:00,191,91,100,Leicht bewölkt,0,0,0,
,2021-01-04 11:00:00,261,133,128,Leicht bewölkt,1,0,0,
,2021-01-04 12:00:00,299,132,167,Leicht bewölkt,2,1,0,
,2021-01-04 13:00:00,290,132,158,Leicht bewölkt,1,0,0,
,2021-01-04 14:00:00,337,167,170,Leicht bewölkt,1,-1,0,
,2021-01-04 15:00:00,331,164,167,Leicht bewölkt,1,-1,0,
,2021-01-04 16:00:00,325,135,190,Leicht bewölkt,1,-2,0,
,2021-01-04 17:00:00,337,129,208,Leicht bewölkt,0,-2,0,
,2021-01-04 18:00:00,216,95,121,Leicht bewölkt,0,-3,0,
,2021-01-04 19:00:00,179,81,98,Leicht bewölkt,0,-3,0,
,2021-01-04 20:00:00,67,33,34,Bedeckt,-1,-3,0,
,2021-01-04 21:00:00,27,8,19,Bedeckt,-1,-3,0,
,2021-01-04 22:00:00,15,6,9,Bedeckt,-2,-4,0,
,2021-01-04 23:00:00,5,0,5,Bewölkt,-2,-4,0,
,2021-01-05 00:00:00,5,2,3,Bewölkt,-3,-5,0,
,2021-01-05 01:00:00,4,2,2,Bewölkt,-3,-5,0,
,2021-01-05 02:00:00,6,4,2,Bedeckt,-2,-4,0,
,2021-01-05 03:00:00,3,1,2,Bedeckt,-2,-4,0,
,2021-01-05 04:00:00,4,2,2,Bedeckt,-2,-4,0,
,2021-01-05 05:00:00,32,22,10,Bedeckt,-2,-3,0,
,2021-01-05 06:00:00,83,49,34,Bedeckt,-1,-2,0,
,2021-01-05 07:00:00,189,129,60,Bedeckt,-1,-2,0,
,2021-01-05 08:00:00,256,160,96,Bedeckt,-1,-1,0,
,2021-01-05 09:00:00,231,139,92,Bedeckt,-1,-1,0,
,2021-01-05 10:00:00,308,170,138,Bedeckt,0,0,0,
,2021-01-05 11:00:00,370,183,187,Bedeckt,1,1,0,
,2021-01-05 12:00:00,362,142,220,Bedeckt,2,1,0,
,2021-01-05 13:00:00,322,152,170,Bedeckt,2,1,0,
,2021-01-05 14:00:00,311,139,172,Leicht bewölkt,2,1,0,
,2021-01-05 15:00:00,352,166,186,Leicht bewölkt,2,2,0,
,2021-01-05 16:00:00,384,189,195,Leicht bewölkt,1,1,0,
,2021-01-05 17:00:00,383,168,215,Leichter Schneefall,1,1,0,
,2021-01-05 18:00:00,268,113,155,Leichter Schneefall,1,1,0,
,2021-01-05 19:00:00,234,118,116,Leichter Schneefall,0,0,0,
,2021-01-05 20:00:00,86,37,49,Bedeckt,0,0,0,
,2021-01-05 21:00:00,27,13,14,Bedeckt,0,0,0,
,2021-01-05 22:00:00,12,6,6,Bedeckt,-1,-1,0,
,2021-01-05 23:00:00,5,2,3,Bedeckt,-1,-2,0,
,2021-01-06 00:00:00,9,3,6,Bedeckt,-2,-3,0,
,2021-01-06 01:00:00,2,2,0,Bedeckt,-2,-3,0,
,2021-01-06 02:00:00,1,1,0,Bedeckt,-2,-3,0,
,2021-01-06 03:00:00,1,0,1,Bedeckt,-2,-4,0,
,2021-01-06 04:00:00,2,2,0,Bedeckt,-2,-4,0,
,2021-01-06 05:00:00,9,8,1,Leichter Schneefall,-2,-4,0,
,2021-01-06 06:00:00,32,26,6,Leichter Schneefall,-2,-4,0,
,2021-01-06 07:00:00,26,21,5,Leichter Schneefall,-2,-4,0,
,2021-01-06 08:00:00,51,30,21,Bedeckt,-2,-4,0.1,
,2021-01-06 09:00:00,51,24,27,Bedeckt,-2,-4,0.1,
,2021-01-06 10:00:00,91,48,43,Bedeckt,-1,-3,0,
,2021-01-06 11:00:00,94,45,49,Starker Schneefall,-1,-3,0,
,2021-01-06 12:00:00,109,52,57,Starker Schneefall,0,-3,0,
,2021-01-06 13:00:00,99,48,51,Starker Schneefall,0,-2,0,
,2021-01-06 14:00:00,117,41,76,Bedeckt,0,-2,0,
,2021-01-06 15:00:00,134,66,68,Bedeckt,0,-2,0,
,2021-01-06 16:00:00,119,53,66,Bedeckt,0,-2,0,
,2021-01-06 17:00:00,139,59,80,Leichter Schneefall,0,-3,0,
,2021-01-06 18:00:00,105,39,66,Leichter Schneefall,-1,-3,0,
,2021-01-06 19:00:00,135,75,60,Leichter Schneefall,-1,-3,0,
,2021-01-06 20:00:00,57,25,32,Bedeckt,-1,-3,0.1,
,2021-01-06 21:00:00,10,4,6,Bedeckt,-1,-4,0.1,
,2021-01-06 22:00:00,9,5,4,Bedeckt,-1,-4,0,
,2021-01-06 23:00:00,7,2,5,Starker Schneefall,-2,-4,0,
,2021-01-07 00:00:00,2,0,2,Starker Schneefall,-2,-4,0,
,2021-01-07 01:00:00,1,1,0,Starker Schneefall,-2,-4,0,
,2021-01-07 02:00:00,1,0,1,Bedeckt,-2,-4,0,
,2021-01-07 03:00:00,1,0,1,Bedeckt,-2,-4,0,
,2021-01-07 04:00:00,3,1,2,Bedeckt,-3,-4,0,
,2021-01-07 05:00:00,22,13,9,Mäßiger Schneefall,-3,-5,0,
,2021-01-07 06:00:00,69,38,31,Mäßiger Schneefall,-3,-5,0,
,2021-01-07 07:00:00,195,110,85,Mäßiger Schneefall,-3,-5,0,
,2021-01-07 08:00:00,225,131,94,Bewölkt,-3,-4,0,
,2021-01-07 09:00:00,186,92,94,Bewölkt,-2,-4,0,
,2021-01-07 10:00:00,192,101,91,Bewölkt,-2,-3,0,
,2021-01-07 11:00:00,224,114,110,Leicht bewölkt,-1,-2,0,
,2021-01-07 12:00:00,229,111,118,Leicht bewölkt,0,-1,0,
,2021-01-07 13:00:00,273,136,137,Leicht bewölkt,0,-1,0,
,2021-01-07 14:00:00,327,162,165,Leicht bewölkt,0,-1,0,
,2021-01-07 15:00:00,329,150,179,Leicht bewölkt,0,-1,0,
,2021-01-07 16:00:00,330,172,158,Leicht bewölkt,-1,-2,0,
,2021-01-07 17:00:00,349,161,188,Leicht bewölkt,-1,-2,0,
,2021-01-07 18:00:00,272,129,143,Leicht bewölkt,-2,-3,0,
,2021-01-07 19:00:00,208,105,103,Leicht bewölkt,-2,-4,0,
,2021-01-07 20:00:00,60,26,34,Leicht bewölkt,-3,-5,0,
,2021-01-07 21:00:00,22,9,13,Leicht bewölkt,-3,-5,0,
,2021-01-07 22:00:00,15,6,9,Leicht bewölkt,-4,-6,0,
,2021-01-07 23:00:00,10,3,7,Bedeckt,-4,-6,0,
,2021-01-08 00:00:00,5,3,2,Bedeckt,-4,-6,0,
,2021-01-08 01:00:00,3,3,0,Bedeckt,-4,-6,0,
,2021-01-08 02:00:00,1,0,1,Leichter Schneefall,-4,-6,0,
,2021-01-08 03:00:00,2,0,2,Leichter Schneefall,-4,-6,0,
,2021-01-08 04:00:00,9,5,4,Leichter Schneefall,-4,-6,0,
,2021-01-08 05:00:00,23,14,9,Bewölkt,-4,-6,0,
,2021-01-08 06:00:00,81,56,25,Bewölkt,-4,-6,0,
,2021-01-08 07:00:00,190,121,69,Bewölkt,-4,-6,0,
,2021-01-08 08:00:00,258,147,111,Bewölkt,-3,-5,0,
,2021-01-08 09:00:00,245,133,112,Bewölkt,-3,-5,0,
,2021-01-08 10:00:00,284,161,123,Bewölkt,-2,-5,0,
,2021-01-08 11:00:00,318,162,156,Bewölkt,-2,-4,0,
,2021-01-08 12:00:00,363,149,214,Bewölkt,-1,-3,0,
,2021-01-08 13:00:00,300,130,170,Bewölkt,-1,-3,0,
,2021-01-08 14:00:00,350,162,188,Leicht bewölkt,-1,-2,0,
,2021-01-08 15:00:00,401,193,208,Leicht bewölkt,-1,-2,0,
,2021-01-08 16:00:00,367,176,191,Leicht bewölkt,-1,-2,0,
,2021-01-08 17:00:00,338,163,175,Leicht bewölkt,-2,-3,0,
,2021-01-08 18:00:00,261,138,123,Leicht bewölkt,-3,-3,0,
,2021-01-08 19:00:00,233,105,128,Leicht bewölkt,-3,-3,0,
,2021-01-08 20:00:00,78,29,49,Leicht bewölkt,-4,-4,0,
,2021-01-08 21:00:00,30,20,10,Leicht bewölkt,-4,-4,0,
,2021-01-08 22:00:00,8,3,5,Leicht bewölkt,-4,-4,0,
,2021-01-08 23:00:00,10,5,5,Leicht bewölkt,-5,-5,0,
,2021-01-09 00:00:00,3,1,2,Leicht bewölkt,-5,-5,0,
,2021-01-09 01:00:00,1,1,0,Leicht bewölkt,-5,-5,0,
,2021-01-09 02:00:00,2,2,0,Leicht bewölkt,-5,-5,0,
,2021-01-09 03:00:00,2,1,1,Leicht bewölkt,-6,-6,0,
,2021-01-09 04:00:00,4,2,2,Leicht bewölkt,-5,-6,0,
,2021-01-09 05:00:00,16,9,7,Leicht bewölkt,-5,-6,0,
,2021-01-09 06:00:00,23,14,9,Leicht bewölkt,-5,-7,0,
,2021-01-09 07:00:00,34,19,15,Leicht bewölkt,-5,-7,0,
,2021-01-09 08:00:00,82,44,38,Leicht bewölkt,-5,-7,0,
,2021-01-09 09:00:00,163,83,80,Leicht bewölkt,-4,-7,0,
,2021-01-09 10:00:00,230,119,111,Leicht bewölkt,-4,-7,0,
,2021-01-09 11:00:00,284,135,149,Leicht bewölkt,-3,-7,0,
,2021-01-09 12:00:00,285,133,152,Leicht bewölkt,-2,-6,0,
,2021-01-09 13:00:00,319,135,184,Leicht bewölkt,-2,-6,0,
,2021-01-09 14:00:00,341,166,175,Leicht bewölkt,-2,-6,0,
,2021-01-09 15:00:00,313,167,146,Leicht bewölkt,-2,-6,0,
,2021-01-09 16:00:00,275,138,137,Leicht bewölkt,-2,-7,0,
,2021-01-09 17:00:00,242,136,106,Leicht bewölkt,-2,-7,0,
,2021-01-09 18:00:00,159,82,77,Leicht bewölkt,-2,-7,0,
,2021-01-09 19:00:00,167,77,90,Leicht bewölkt,-3,-8,0,
,2021-01-09 20:00:00,68,34,34,Bewölkt,-3,-8,0,
,2021-01-09 21:00:00,18,8,10,Bewölkt,-3,-8,0,
,2021-01-09 22:00:00,13,7,6,Bewölkt,-3,-8,0,
,2021-01-09 23:00:00,5,2,3,Bewölkt,-3,-8,0,
,2021-01-10 00:00:00,6,4,2,Bewölkt,-3,-8,0,
,2021-01-10 01:00:00,2,1,1,Bewölkt,-4,-9,0,
,2021-01-10 02:00:00,4,3,1,Bewölkt,-4,-9,0,
,2021-01-10 03:00:00,1,1,0,Bewölkt,-5,-10,0,
,2021-01-10 04:00:00,1,1,0,Bewölkt,-5,-10,0,
,2021-01-10 05:00:00,8,3,5,Bewölkt,-5,-10,0,
,2021-01-10 06:00:00,16,11,5,Bewölkt,-6,-11,0,
,2021-01-10 07:00:00,18,11,7,Bewölkt,-5,-10,0,
,2021-01-10 08:00:00,33,16,17,Leichter Schneefall,-5,-10,0,
,2021-01-10 09:00:00,75,43,32,Leichter Schneefall,-5,-10,0,
,2021-01-10 10:00:00,76,36,40,Leichter Schneefall,-4,-9,0,
,2021-01-10 11:00:00,147,59,88,Bewölkt,-3,-8,0,
,2021-01-10 12:00:00,188,87,101,Bewölkt,-3,-7,0,
,2021-01-10 13:00:00,211,101,110,Bewölkt,-2,-7,0,
,2021-01-10 14:00:00,289,119,170,Leicht bewölkt,-2,-7,0,
,2021-01-10 15:00:00,224,122,102,Leicht bewölkt,-2,-7,0,
,2021-01-10 16:00:00,281,131,150,Leicht bewölkt,-3,-8,0,
,2021-01-10 17:00:00,178,92,86,Bewölkt,-4,-9,0,
,2021-01-10 18:00:00,117,61,56,Bewölkt,-4,-10,0,
,2021-01-10 19:00:00,149,81,68,Bewölkt,-5,-10,0,
,2021-01-10 20:00:00,62,30,32,Leichter Schneefall,-5,-11,0,
,2021-01-10 21:00:00,18,9,9,Leichter Schneefall,-6,-11,0,
,2021-01-10 22:00:00,9,6,3,Leichter Schneefall,-7,-11,0,
,2021-01-10 23:00:00,7,3,4,Leicht bewölkt,-8,-12,0,
,2021-01-11 00:00:00,4,2,2,Leicht bewölkt,-8,-12,0,
,2021-01-11 01:00:00,5,4,1,Leicht bewölkt,-9,-12,0,
,2021-01-11 02:00:00,2,1,1,Leicht bewölkt,-9,-13,0,
,2021-01-11 03:00:00,3,1,2,Leicht bewölkt,-10,-13,0,
,2021-01-11 04:00:00,4,2,2,Leicht bewölkt,-10,-13,0,
,2021-01-11 05:00:00,27,18,9,Leicht bewölkt,-10,-13,0,
,2021-01-11 06:00:00,138,84,54,Leicht bewölkt,-10,-13,0,
,2021-01-11 07:00:00,315,184,131,Leicht bewölkt,-9,-12,0,
,2021-01-11 08:00:00,407,227,180,Leicht bewölkt,-9,-10,0,
,2021-01-11 09:00:00,279,158,121,Leicht bewölkt,-8,-9,0,
,2021-01-11 10:00:00,226,119,107,Leicht bewölkt,-6,-7,0,
,2021-01-11 11:00:00,237,107,130,Leicht bewölkt,-5,-5,0,
,2021-01-11 12:00:00,347,145,202,Leicht bewölkt,-3,-3,0,
,2021-01-11 13:00:00,337,166,171,Leicht bewölkt,-3,-3,0,
,2021-01-11 14:00:00,327,178,149,Sonnig,-3,-3,0,
,2021-01-11 15:00:00,395,204,191,Sonnig,-3,-3,0,
,2021-01-11 16:00:00,455,225,230,Sonnig,-4,-4,0,
,2021-01-11 17:00:00,471,196,275,Leicht bewölkt,-5,-6,0,
,2021-01-11 18:00:00,309,142,167,Leicht bewölkt,-7,-8,0,
,2021-01-11 19:00:00,220,104,116,Leicht bewölkt,-8,-9,0,
,2021-01-11 20:00:00,78,39,39,Leicht bewölkt,-9,-10,0,
,2021-01-11 21:00:00,31,12,19,Leicht bewölkt,-11,-11,0,
,2021-01-11 22:00:00,12,3,9,Leicht bewölkt,-9,-11,0,
,2021-01-11 23:00:00,3,2,1,Bedeckt,-8,-10,0,
,2021-01-12 00:00:00,4,1,3,Bedeckt,-7,-10,0,
,2021-01-12 01:00:00,4,4,0,Bedeckt,-7,-10,0,
,2021-01-12 02:00:00,0,0,0,Leicht bewölkt,-6,-9,0,
,2021-01-12 03:00:00,1,0,1,Leicht bewölkt,-6,-9,0,
,2021-01-12 04:00:00,5,3,2,Leicht bewölkt,-5,-9,0,
,2021-01-12 05:00:00,29,20,9,Bewölkt,-4,-8,0,
,2021-01-12 06:00:00,120,72,48,Bewölkt,-4,-8,0,
,2021-01-12 07:00:00,310,182,128,Bewölkt,-3,-7,0,
,2021-01-12 08:00:00,416,238,178,Bedeckt,-2,-6,0.2,
,2021-01-12 09:00:00,313,167,146,Bedeckt,-1,-6,0.2,
,2021-01-12 10:00:00,237,130,107,Bedeckt,0,-5,0.1,
,2021-01-12 11:00:00,282,129,153,Starker Schneefall,0,-5,0.1,
,2021-01-12 12:00:00,318,141,177,Starker Schneefall,1,-4,0.1,
,2021-01-12 13:00:00,296,127,169,Starker Schneefall,1,-4,0.1,
,2021-01-12 14:00:00,257,132,125,Bedeckt,1,-4,0.2,
,2021-01-12 15:00:00,271,127,144,Bedeckt,2,-3,0.3,
,2021-01-12 16:00:00,309,149,160,Bedeckt,1,-2,0.1,
,2021-01-12 17:00:00,344,152,192,Starker Schneefall,1,-2,0.1,
,2021-01-12 18:00:00,250,92,158,Starker Schneefall,1,-1,0.1,
,2021-01-12 19:00:00,170,81,89,Starker Schneefall,-1,-2,0.1,
,2021-01-12 20:00:00,74,40,34,Bedeckt,-2,-2,0.5,
,2021-01-12 21:00:00,24,10,14,Bedeckt,-3,-3,0.7,
,2021-01-12 22:00:00,17,9,8,Bedeckt,-2,-3,0.4,
,2021-01-12 23:00:00,4,3,1,Leichter Regenfall,-2,-3,0.7,
,2021-01-13 00:00:00,2,2,0,Leichter Regenfall,-1,-3,0.9,
,2021-01-13 01:00:00,4,3,1,Leichter Regenfall,0,-2,0.4,
,2021-01-13 02:00:00,1,0,1,Leichter Eisregen,0,-2,0.3,
,2021-01-13 03:00:00,1,0,1,Leichter Eisregen,1,-2,0.4,
,2021-01-13 04:00:00,4,2,2,Leichter Eisregen,1,-2,0.2,
,2021-01-13 05:00:00,32,21,11,Stellenweise starker Schneefall,1,-2,0.1,
,2021-01-13 06:00:00,95,59,36,Stellenweise starker Schneefall,0,-3,0.2,
,2021-01-13 07:00:00,255,153,102,Stellenweise starker Schneefall,1,-2,0.1,
,2021-01-13 08:00:00,416,227,189,Starker Schneefall,1,-2,0,
,2021-01-13 09:00:00,252,146,106,Starker Schneefall,1,-2,0,
,2021-01-13 10:00:00,216,111,105,Starker Schneefall,2,-2,0,
,2021-01-13 11:00:00,289,149,140,Stellenweise leichter Schneefall,2,-1,0,
,2021-01-13 12:00:00,324,148,176,Stellenweise leichter Schneefall,3,-1,0,
,2021-01-13 13:00:00,382,178,204,Stellenweise leichter Schneefall,3,-1,0,
,2021-01-13 14:00:00,378,194,184,Leicht bewölkt,3,-1,0,
,2021-01-13 15:00:00,399,199,200,Leicht bewölkt,3,-1,0,
,2021-01-13 16:00:00,484,239,245,Leicht bewölkt,3,-1,0,
,2021-01-13 17:00:00,465,217,248,Leicht bewölkt,3,-2,0.2,
,2021-01-13 18:00:00,319,140,179,Leicht bewölkt,3,-2,0.2,
,2021-01-13 19:00:00,239,103,136,Leicht bewölkt,2,-2,0.1,
,2021-01-13 20:00:00,80,42,38,Leichter Eisregen,2,-1,0.8,
,2021-01-13 21:00:00,22,10,12,Leichter Eisregen,2,-1,1.1,
,2021-01-13 22:00:00,16,11,5,Leichter Eisregen,1,-2,0.5,
,2021-01-13 23:00:00,7,2,5,Starker Schneefall,0,-2,2,
,2021-01-14 00:00:00,6,3,3,Starker Schneefall,-1,-2,2.7,
,2021-01-14 01:00:00,4,3,1,Starker Schneefall,0,-2,1.3,
,2021-01-14 02:00:00,0,0,0,Starker Regenfall,1,-2,2.1,
,2021-01-14 03:00:00,2,0,2,Starker Regenfall,1,-2,2.8,
,2021-01-14 04:00:00,6,3,3,Starker Regenfall,1,-2,1.4,
,2021-01-14 05:00:00,29,20,9,Starker Schneefall,1,-3,2.9,
,2021-01-14 06:00:00,67,43,24,Starker Schneefall,0,-3,3.8,
,2021-01-14 07:00:00,213,102,111,Starker Schneefall,0,-3,1.9,
,2021-01-14 08:00:00,252,130,122,Starker Schneefall,0,-2,1.8,
,2021-01-14 09:00:00,148,80,68,Starker Schneefall,0,-2,2.4,
,2021-01-14 10:00:00,77,33,44,Starker Schneefall,0,-2,1.2,
,2021-01-14 11:00:00,88,43,45,Starker Schneefall,0,-2,1.5,
,2021-01-14 12:00:00,114,58,56,Starker Schneefall,1,-2,2,
,2021-01-14 13:00:00,122,59,63,Starker Schneefall,0,-2,1,
,2021-01-14 14:00:00,98,36,62,Starker Schneefall,0,-1,0.7,
,2021-01-14 15:00:00,74,43,31,Starker Schneefall,0,-1,1,
,2021-01-14 16:00:00,87,43,44,Starker Schneefall,0,-1,0.5,
,2021-01-14 17:00:00,102,52,50,Starker Schneefall,-1,-2,0.3,
,2021-01-14 18:00:00,67,35,32,Starker Schneefall,-1,-2,0.4,
,2021-01-14 19:00:00,85,42,43,Starker Schneefall,-2,-3,0.2,
,2021-01-14 20:00:00,26,13,13,Starker Schneefall,-2,-4,0.2,
,2021-01-14 21:00:00,10,6,4,Starker Schneefall,-3,-5,0.3,
,2021-01-14 22:00:00,6,2,4,Starker Schneefall,-3,-6,0.2,
,2021-01-14 23:00:00,4,2,2,Starker Schneefall,-3,-6,1.3,
,2021-01-15 00:00:00,0,0,0,Starker Schneefall,-3,-6,1.7,
,2021-01-15 01:00:00,4,4,0,Starker Schneefall,-3,-7,0.9,
,2021-01-15 02:00:00,2,0,2,Starker Schneefall,-3,-7,1,
,2021-01-15 03:00:00,0,0,0,Starker Schneefall,-4,-7,1.3,
,2021-01-15 04:00:00,0,0,0,Starker Schneefall,-5,-8,0.7,
,2021-01-15 05:00:00,6,4,2,Starker Schneefall,-5,-10,1,
,2021-01-15 06:00:00,15,6,9,Starker Schneefall,-6,-11,1.4,
,2021-01-15 07:00:00,38,27,11,Starker Schneefall,-6,-10,0.7,
,2021-01-15 08:00:00,67,30,37,Stellenweise starker Schneefall,-6,-10,0.5,
,2021-01-15 09:00:00,61,31,30,Stellenweise starker Schneefall,-6,-10,0.6,
,2021-01-15 10:00:00,55,25,30,Stellenweise starker Schneefall,-5,-8,0.3,
,2021-01-15 11:00:00,43,25,18,Stellenweise starker Schneefall,-4,-7,0.1,
,2021-01-15 12:00:00,80,36,44,Stellenweise starker Schneefall,-3,-6,0.1,
,2021-01-15 13:00:00,103,52,51,Stellenweise starker Schneefall,-3,-6,0.1,
,2021-01-15 14:00:00,104,53,51,Stellenweise starker Schneefall,-3,-6,0,
,2021-01-15 15:00:00,87,37,50,Stellenweise starker Schneefall,-3,-5,0,
,2021-01-15 16:00:00,98,48,50,Stellenweise starker Schneefall,-3,-6,0,
,2021-01-15 17:00:00,88,53,35,Bewölkt,-4,-6,0,
,2021-01-15 18:00:00,67,37,30,Bewölkt,-5,-7,0,
,2021-01-15 19:00:00,57,28,29,Bewölkt,-5,-7,0,
,2021-01-15 20:00:00,24,11,13,Leichter Schneefall,-5,-7,0,
,2021-01-15 21:00:00,3,1,2,Leichter Schneefall,-6,-8,0,
,2021-01-15 22:00:00,7,3,4,Leichter Schneefall,-6,-7,0,
,2021-01-15 23:00:00,3,3,0,Leichter Schneefall,-6,-7,0,
,2021-01-16 00:00:00,1,1,0,Leichter Schneefall,-5,-7,0,
,2021-01-16 01:00:00,7,6,1,Leichter Schneefall,-6,-8,0,
,2021-01-16 02:00:00,0,0,0,Bedeckt,-7,-8,0,
,2021-01-16 03:00:00,1,0,1,Bedeckt,-7,-8,0,
,2021-01-16 04:00:00,1,0,1,Bedeckt,-8,-8,0,
,2021-01-16 05:00:00,9,6,3,Leichter Schneefall,-8,-8,0,
,2021-01-16 06:00:00,7,3,4,Leichter Schneefall,-9,-9,0,
,2021-01-16 07:00:00,11,6,5,Leichter Schneefall,-8,-9,0,
,2021-01-16 08:00:00,23,15,8,Leichter Schneefall,-8,-8,0,
,2021-01-16 09:00:00,44,19,25,Leichter Schneefall,-7,-8,0,
,2021-01-16 10:00:00,67,33,34,Leichter Schneefall,-6,-7,0,
,2021-01-16 11:00:00,81,32,49,Leicht bewölkt,-5,-6,0,
,2021-01-16 12:00:00,92,51,41,Leicht bewölkt,-4,-5,0,
,2021-01-16 13:00:00,94,44,50,Leicht bewölkt,-4,-4,0,
,2021-01-16 14:00:00,90,33,57,Leicht bewölkt,-4,-4,0,
,2021-01-16 15:00:00,85,39,46,Leicht bewölkt,-4,-4,0,
,2021-01-16 16:00:00,70,33,37,Leicht bewölkt,-5,-5,0,
,2021-01-16 17:00:00,76,41,35,Leicht bewölkt,-5,-5,0,
,2021-01-16 18:00:00,49,31,18,Leicht bewölkt,-6,-6,0,
,2021-01-16 19:00:00,72,41,31,Leicht bewölkt,-7,-7,0,
,2021-01-16 20:00:00,23,12,11,Leicht bewölkt,-7,-7,0,
,2021-01-16 21:00:00,6,3,3,Leicht bewölkt,-8,-8,0,
,2021-01-16 22:00:00,3,0,3,Leicht bewölkt,-7,-8,0,
,2021-01-16 23:00:00,6,3,3,Bedeckt,-7,-8,0,
,2021-01-17 00:00:00,5,3,2,Bedeckt,-6,-8,0,
,2021-01-17 01:00:00,3,1,2,Bedeckt,-5,-7,0,
,2021-01-17 02:00:00,2,2,0,Bedeckt,-5,-7,0.6,
,2021-01-17 03:00:00,0,0,0,Bedeckt,-4,-7,0.8,
,2021-01-17 04:00:00,0,0,0,Bedeckt,-3,-7,0.4,
,2021-01-17 05:00:00,2,1,1,Starker Schneefall,-2,-6,1.4,
,2021-01-17 06:00:00,4,1,3,Starker Schneefall,-2,-5,1.8,
,2021-01-17 07:00:00,21,8,13,Starker Schneefall,-1,-5,0.9,
,2021-01-17 08:00:00,15,8,7,Starker Schneefall,0,-4,1,
,2021-01-17 09:00:00,15,6,9,Starker Schneefall,1,-4,1.3,
,2021-01-17 10:00:00,14,5,9,Starker Schneefall,1,-3,0.6,
,2021-01-17 11:00:00,25,11,14,Starker Schneefall,1,-3,0.6,
,2021-01-17 12:00:00,29,9,20,Starker Schneefall,2,-3,0.8,
,2021-01-17 13:00:00,32,12,20,Starker Schneefall,2,-3,0.4,
,2021-01-17 14:00:00,60,29,31,Starker Schneefall,2,-3,0.4,
,2021-01-17 15:00:00,60,24,36,Starker Schneefall,2,-3,0.5,
,2021-01-17 16:00:00,69,42,27,Starker Schneefall,1,-3,0.3,
,2021-01-17 17:00:00,69,43,26,Starker Schneefall,1,-3,0.1,
,2021-01-17 18:00:00,51,27,24,Starker Schneefall,1,-3,0.1,
,2021-01-17 19:00:00,46,29,17,Starker Schneefall,1,-3,0.1,
,2021-01-17 20:00:00,23,12,11,Nebel,0,-4,0.1,
,2021-01-17 21:00:00,11,6,5,Nebel,0,-4,0.1,
,2021-01-17 22:00:00,5,3,2,Nebel,0,-4,0.1,
,2021-01-17 23:00:00,1,0,1,Starker Schneefall,0,-4,0.3,
,2021-01-18 00:00:00,1,0,1,Starker Schneefall,0,-4,0.4,
,2021-01-18 01:00:00,3,2,1,Starker Schneefall,0,-4,0.2,
,2021-01-18 02:00:00,4,2,2,Starker Schneefall,0,-4,0.1,
,2021-01-18 03:00:00,1,0,1,Starker Schneefall,0,-4,0.2,
,2021-01-18 04:00:00,7,5,2,Starker Schneefall,0,-4,0.1,
,2021-01-18 05:00:00,15,7,8,Starker Schneefall,0,-4,0,
,2021-01-18 06:00:00,59,33,26,Starker Schneefall,-1,-4,0,
,2021-01-18 07:00:00,185,98,87,Starker Schneefall,-1,-4,0,
,2021-01-18 08:00:00,209,86,123,Leichter Nebel,-1,-4,0,
,2021-01-18 09:00:00,193,100,93,Leichter Nebel,-1,-4,0,
,2021-01-18 10:00:00,139,72,67,Leichter Nebel,0,-3,0,
,2021-01-18 11:00:00,141,70,71,Mäßiger Schneefall,0,-3,0,
,2021-01-18 12:00:00,207,104,103,Mäßiger Schneefall,1,-2,0,
,2021-01-18 13:00:00,252,125,127,Mäßiger Schneefall,1,-2,0,
,2021-01-18 14:00:00,224,117,107,Bewölkt,1,-2,0,
,2021-01-18 15:00:00,206,96,110,Bewölkt,1,-2,0,
,2021-01-18 16:00:00,241,131,110,Bewölkt,0,-2,0,
,2021-01-18 17:00:00,269,145,124,Stellenweise leichter Schneefall,-1,-2,0,
,2021-01-18 18:00:00,195,91,104,Stellenweise leichter Schneefall,-1,-3,0,
,2021-01-18 19:00:00,127,61,66,Stellenweise leichter Schneefall,-2,-4,0,
,2021-01-18 20:00:00,53,30,23,Leicht bewölkt,-3,-4,0,
,2021-01-18 21:00:00,23,11,12,Leicht bewölkt,-3,-5,0,
,2021-01-18 22:00:00,10,5,5,Leicht bewölkt,-3,-6,0,
,2021-01-18 23:00:00,10,8,2,Leicht bewölkt,-4,-6,0,
,2021-01-19 00:00:00,3,2,1,Leicht bewölkt,-4,-7,0,
,2021-01-19 01:00:00,1,0,1,Leicht bewölkt,-4,-7,0,
,2021-01-19 02:00:00,1,0,1,Leicht bewölkt,-5,-7,0,
,2021-01-19 03:00:00,2,1,1,Leicht bewölkt,-5,-8,0,
,2021-01-19 04:00:00,3,2,1,Leicht bewölkt,-5,-8,0,
,2021-01-19 05:00:00,19,10,9,Bedeckt,-5,-8,0,
,2021-01-19 06:00:00,71,42,29,Bedeckt,-5,-8,0,
,2021-01-19 07:00:00,246,124,122,Bedeckt,-4,-7,0,
,2021-01-19 08:00:00,309,156,153,Bedeckt,-3,-6,0,
,2021-01-19 09:00:00,200,103,97,Bedeckt,-2,-5,0,
,2021-01-19 10:00:00,157,87,70,Bedeckt,-1,-4,0,
,2021-01-19 11:00:00,184,100,84,Bewölkt,0,-3,0,
,2021-01-19 12:00:00,264,125,139,Bewölkt,1,-2,0,
,2021-01-19 13:00:00,275,142,133,Bewölkt,1,-1,0,
,2021-01-19 14:00:00,249,126,123,Bedeckt,2,0,0,
,2021-01-19 15:00:00,269,140,129,Bedeckt,2,0,0,
,2021-01-19 16:00:00,307,152,155,Bedeckt,2,0,0,
,2021-01-19 17:00:00,318,152,166,Leicht bewölkt,2,0,0,
,2021-01-19 18:00:00,242,111,131,Leicht bewölkt,2,-1,0,
,2021-01-19 19:00:00,181,92,89,Leicht bewölkt,1,-1,0,
,2021-01-19 20:00:00,53,30,23,Leicht bewölkt,0,-2,0,
,2021-01-19 21:00:00,21,7,14,Leicht bewölkt,-1,-3,0,
,2021-01-19 22:00:00,11,6,5,Leicht bewölkt,-1,-4,0,
,2021-01-19 23:00:00,4,4,0,Leicht bewölkt,-1,-4,0,
,2021-01-20 00:00:00,4,4,0,Leicht bewölkt,-1,-4,0,
,2021-01-20 01:00:00,2,0,2,Leicht bewölkt,-2,-4,0,
,2021-01-20 02:00:00,1,0,1,Sonnig,-2,-5,0,
,2021-01-20 03:00:00,2,1,1,Sonnig,-2,-5,0,
,2021-01-20 04:00:00,4,4,0,Sonnig,-3,-5,0,
,2021-01-20 05:00:00,31,16,15,Sonnig,-3,-6,0,
,2021-01-20 06:00:00,80,41,39,Sonnig,-3,-6,0,
,2021-01-20 07:00:00,245,112,133,Sonnig,-3,-6,0,
,2021-01-20 08:00:00,333,173,160,Leicht bewölkt,-2,-5,0,
,2021-01-20 09:00:00,197,107,90,Leicht bewölkt,-2,-5,0,
,2021-01-20 10:00:00,158,91,67,Leicht bewölkt,-1,-3,0,
,2021-01-20 11:00:00,218,106,112,Leicht bewölkt,0,-2,0,
,2021-01-20 12:00:00,292,147,145,Leicht bewölkt,1,-1,0,
,2021-01-20 13:00:00,315,147,168,Leicht bewölkt,1,0,0,
,2021-01-20 14:00:00,211,112,99,Leicht bewölkt,2,0,0,
,2021-01-20 15:00:00,4,2,2,Leicht bewölkt,2,1,0,
,2021-01-20 16:00:00,367,203,164,Leicht bewölkt,1,0,0,
,2021-01-20 17:00:00,370,196,174,Leicht bewölkt,0,-1,0,
,2021-01-20 18:00:00,250,129,121,Leicht bewölkt,0,-2,0,
,2021-01-20 19:00:00,203,86,117,Leicht bewölkt,-2,-3,0,
,2021-01-20 20:00:00,71,33,38,Leicht bewölkt,-3,-4,0,
,2021-01-20 21:00:00,23,13,10,Leicht bewölkt,-5,-6,0,
,2021-01-20 22:00:00,15,10,5,Leicht bewölkt,-4,-5,0,
,2021-01-20 23:00:00,4,3,1,Leicht bewölkt,-3,-5,0,
,2021-01-21 00:00:00,4,2,2,Leicht bewölkt,-2,-4,0,
,2021-01-21 01:00:00,0,0,0,Leicht bewölkt,-2,-4,0,
,2021-01-21 02:00:00,0,0,0,Leicht bewölkt,-2,-5,0,
,2021-01-21 03:00:00,2,1,1,Leicht bewölkt,-2,-5,0,
,2021-01-21 04:00:00,5,1,4,Leicht bewölkt,-2,-5,0,
,2021-01-21 05:00:00,28,17,11,Leicht bewölkt,-2,-5,0,
,2021-01-21 06:00:00,84,46,38,Leicht bewölkt,-2,-5,0,
,2021-01-21 07:00:00,313,170,143,Leicht bewölkt,-2,-4,0,
,2021-01-21 08:00:00,387,199,188,Bewölkt,-1,-3,0,
,2021-01-21 09:00:00,275,133,142,Bewölkt,0,-3,0,
,2021-01-21 10:00:00,214,96,118,Bewölkt,1,-1,0,
,2021-01-21 11:00:00,257,136,121,Leicht bewölkt,2,0,0,
,2021-01-21 12:00:00,362,189,173,Leicht bewölkt,3,1,0,
,2021-01-21 13:00:00,356,169,187,Leicht bewölkt,2,1,0,
,2021-01-21 14:00:00,347,170,177,Leicht bewölkt,2,1,0,
,2021-01-21 15:00:00,355,175,180,Leicht bewölkt,2,1,0,
,2021-01-21 16:00:00,423,234,189,Leicht bewölkt,2,1,0,
,2021-01-21 17:00:00,439,221,218,Leichter Nebel,1,0,0,
,2021-01-21 18:00:00,278,133,145,Leichter Nebel,1,0,0,
,2021-01-21 19:00:00,215,116,99,Leichter Nebel,-1,-1,0,
,2021-01-21 20:00:00,93,46,47,Bedeckt,-2,-3,0,
,2021-01-21 21:00:00,28,13,15,Bedeckt,-4,-4,0,
,2021-01-21 22:00:00,7,4,3,Bedeckt,-3,-4,0,
,2021-01-21 23:00:00,8,6,2,Bedeckt,-2,-4,0,
,2021-01-22 00:00:00,2,1,1,Bedeckt,-2,-3,0,
,2021-01-22 01:00:00,2,2,0,Bedeckt,-1,-3,0,
,2021-01-22 02:00:00,1,0,1,Bewölkt,-1,-2,0,
,2021-01-22 03:00:00,3,2,1,Bewölkt,0,-2,0,
,2021-01-22 04:00:00,7,3,4,Bewölkt,0,-2,0,
,2021-01-22 05:00:00,29,16,13,Bewölkt,1,-1,0,
,2021-01-22 06:00:00,95,54,41,Bewölkt,1,-1,0,
,2021-01-22 07:00:00,273,143,130,Bewölkt,2,0,0,
,2021-01-22 08:00:00,404,206,198,Leicht bewölkt,2,1,0,
,2021-01-22 09:00:00,345,209,136,Leicht bewölkt,3,1,0,
,2021-01-22 10:00:00,326,163,163,Leicht bewölkt,3,2,0,
,2021-01-22 11:00:00,396,195,201,Leicht bewölkt,4,3,0,
,2021-01-22 12:00:00,439,199,240,Leicht bewölkt,5,4,0,
,2021-01-22 13:00:00,411,200,211,Leicht bewölkt,4,3,0,
,2021-01-22 14:00:00,451,238,213,Leicht bewölkt,4,3,0,
,2021-01-22 15:00:00,399,221,178,Leicht bewölkt,4,2,0,
,2021-01-22 16:00:00,466,206,260,Leicht bewölkt,3,1,0,
,2021-01-22 17:00:00,404,209,195,Leichter Nebel,2,0,0,
,2021-01-22 18:00:00,248,115,133,Leichter Nebel,1,-1,0,
,2021-01-22 19:00:00,252,122,130,Leichter Nebel,1,-1,0,
,2021-01-22 20:00:00,76,40,36,Leichter Nebel,0,-2,0,
,2021-01-22 21:00:00,15,10,5,Leichter Nebel,-1,-3,0,
,2021-01-22 22:00:00,14,9,5,Leichter Nebel,0,-2,0,
,2021-01-22 23:00:00,4,2,2,Leichter Nebel,1,-2,0.1,
,2021-01-23 00:00:00,5,1,4,Leichter Nebel,1,-1,0.2,
,2021-01-23 01:00:00,5,4,1,Leichter Nebel,1,-2,0.1,
,2021-01-23 02:00:00,2,1,1,Leichter Eisregen,1,-3,1.8,
,2021-01-23 03:00:00,3,0,3,Leichter Eisregen,1,-4,2.4,
,2021-01-23 04:00:00,6,1,5,Leichter Eisregen,1,-4,1.2,
,2021-01-23 05:00:00,21,15,6,Starker Schneefall,1,-4,1.3,
,2021-01-23 06:00:00,20,16,4,Starker Schneefall,1,-4,1.7,
,2021-01-23 07:00:00,41,14,27,Starker Schneefall,1,-3,0.8,
,2021-01-23 08:00:00,87,50,37,Starker Schneefall,1,-2,0.2,
,2021-01-23 09:00:00,157,92,65,Starker Schneefall,1,-2,0.3,
,2021-01-23 10:00:00,242,123,119,Starker Schneefall,2,-1,0.1,
,2021-01-23 11:00:00,297,165,132,Mäßiger Schneefall,2,0,0,
,2021-01-23 12:00:00,301,135,166,Mäßiger Schneefall,3,1,0,
,2021-01-23 13:00:00,325,153,172,Mäßiger Schneefall,2,1,0,
,2021-01-23 14:00:00,319,161,158,Bedeckt,2,1,0,
,2021-01-23 15:00:00,320,168,152,Bedeckt,2,1,0,
,2021-01-23 16:00:00,342,180,162,Bedeckt,2,1,0,
,2021-01-23 17:00:00,230,113,117,Bedeckt,1,0,0,
,2021-01-23 18:00:00,177,87,90,Bedeckt,0,0,0,
,2021-01-23 19:00:00,182,112,70,Bedeckt,-1,-1,0,
,2021-01-23 20:00:00,59,34,25,Leicht bewölkt,-1,-1,0,
,2021-01-23 21:00:00,10,4,6,Leicht bewölkt,-2,-2,0,
,2021-01-23 22:00:00,14,7,7,Leicht bewölkt,-2,-3,0,
,2021-01-23 23:00:00,11,6,5,Stellenweise leichter Schneefall,-1,-4,0.3,
,2021-01-24 00:00:00,4,3,1,Stellenweise leichter Schneefall,-1,-4,0.7,
,2021-01-24 01:00:00,5,5,0,Stellenweise leichter Schneefall,-1,-4,0.3,
,2021-01-24 02:00:00,1,0,1,Mäßiger bis starker Schneefall mit Gewitter,0,-4,0.3,
,2021-01-24 03:00:00,6,1,5,Mäßiger bis starker Schneefall mit Gewitter,0,-4,0.4,
,2021-01-24 04:00:00,1,1,0,Mäßiger bis starker Schneefall mit Gewitter,0,-4,0.2,
,2021-01-24 05:00:00,12,8,4,Mäßiger bis starker Schneefall mit Gewitter,0,-5,0.1,
,2021-01-24 06:00:00,18,14,4,Mäßiger bis starker Schneefall mit Gewitter,-1,-5,0.1,
,2021-01-24 07:00:00,14,8,6,Mäßiger bis starker Schneefall mit Gewitter,-1,-5,0.1,
,2021-01-24 08:00:00,28,18,10,Bewölkt,-1,-6,0,
,2021-01-24 09:00:00,77,42,35,Bewölkt,-1,-6,0,
,2021-01-24 10:00:00,124,52,72,Bewölkt,-1,-5,0,
,2021-01-24 11:00:00,161,76,85,Stellenweise mäßiger Schneefall,0,-5,0,
,2021-01-24 12:00:00,189,76,113,Stellenweise mäßiger Schneefall,0,-5,0,
,2021-01-24 13:00:00,218,97,121,Stellenweise mäßiger Schneefall,0,-4,0,
,2021-01-24 14:00:00,292,130,162,Leicht bewölkt,0,-4,0,
,2021-01-24 15:00:00,233,138,95,Leicht bewölkt,0,-4,0,
,2021-01-24 16:00:00,229,118,111,Leicht bewölkt,-1,-4,0,
,2021-01-24 17:00:00,168,88,80,Stellenweiser Schneefall,-2,-5,0,
,2021-01-24 18:00:00,112,62,50,Stellenweiser Schneefall,-3,-6,0,
,2021-01-24 19:00:00,120,67,53,Stellenweiser Schneefall,-4,-7,0,
,2021-01-24 20:00:00,49,25,24,Leicht bewölkt,-5,-8,0,
,2021-01-24 21:00:00,16,10,6,Leicht bewölkt,-6,-9,0,
,2021-01-24 22:00:00,8,6,2,Leicht bewölkt,-6,-8,0,
,2021-01-24 23:00:00,4,3,1,Leicht bewölkt,-6,-8,0,
,2021-01-25 00:00:00,3,1,2,Leicht bewölkt,-6,-7,0.1,
,2021-01-25 01:00:00,3,3,0,Leicht bewölkt,-6,-7,0,
,2021-01-25 02:00:00,1,0,1,Mäßiger Schneefall,-6,-8,0.3,
,2021-01-25 03:00:00,0,0,0,Mäßiger Schneefall,-6,-9,0.4,
,2021-01-25 04:00:00,6,4,2,Mäßiger Schneefall,-5,-8,0.2,
,2021-01-25 05:00:00,21,10,11,Starker Schneefall,-4,-8,0.7,
,2021-01-25 06:00:00,70,41,29,Starker Schneefall,-4,-7,0.9,
,2021-01-25 07:00:00,215,106,109,Starker Schneefall,-3,-6,0.5,
,2021-01-25 08:00:00,281,141,140,Mäßiger bis starker Schneefall mit Gewitter,-2,-6,0.4,
,2021-01-25 09:00:00,191,115,76,Mäßiger bis starker Schneefall mit Gewitter,-1,-5,0.6,
,2021-01-25 10:00:00,146,78,68,Mäßiger bis starker Schneefall mit Gewitter,0,-5,0.3,
,2021-01-25 11:00:00,192,80,112,Starker Schneefall,0,-5,0.1,
,2021-01-25 12:00:00,278,150,128,Starker Schneefall,1,-5,0.1,
,2021-01-25 13:00:00,289,156,133,Starker Schneefall,1,-5,0.1,
,2021-01-25 14:00:00,277,140,137,Mäßige bis starke Schneefälle,1,-5,0.2,
,2021-01-25 15:00:00,297,173,124,Mäßige bis starke Schneefälle,1,-5,0.3,
,2021-01-25 16:00:00,327,183,144,Mäßige bis starke Schneefälle,0,-5,0.2,
,2021-01-25 17:00:00,351,159,192,Mäßiger bis starker Schneefall mit Gewitter,0,-5,0.2,
,2021-01-25 18:00:00,233,113,120,Mäßiger bis starker Schneefall mit Gewitter,0,-5,0.3,
,2021-01-25 19:00:00,202,105,97,Mäßiger bis starker Schneefall mit Gewitter,-1,-6,0.1,
,2021-01-25 20:00:00,70,30,40,Starker Schneefall,-1,-6,0.2,
,2021-01-25 21:00:00,20,11,9,Starker Schneefall,-1,-6,0.2,
,2021-01-25 22:00:00,11,6,5,Starker Schneefall,-2,-7,0.1,
,2021-01-25 23:00:00,5,3,2,Starker Schneefall,-3,-7,0.5,
,2021-01-26 00:00:00,2,2,0,Starker Schneefall,-3,-8,1,
,2021-01-26 01:00:00,5,5,0,Starker Schneefall,-3,-8,0.5,
,2021-01-26 02:00:00,1,1,0,Starker Schneefall,-3,-8,0.3,
,2021-01-26 03:00:00,2,0,2,Starker Schneefall,-3,-8,0.4,
,2021-01-26 04:00:00,3,1,2,Starker Schneefall,-3,-8,0.2,
,2021-01-26 05:00:00,30,19,11,Starker Schneefall,-3,-8,0.2,
,2021-01-26 06:00:00,113,63,50,Starker Schneefall,-3,-8,0.3,
,2021-01-26 07:00:00,295,176,119,Starker Schneefall,-3,-8,0.2,
,2021-01-26 08:00:00,394,226,168,Starker Schneefall,-3,-8,0.1,
,2021-01-26 09:00:00,261,145,116,Starker Schneefall,-3,-8,0.1,
,2021-01-26 10:00:00,253,135,118,Starker Schneefall,-2,-7,0.1,
,2021-01-26 11:00:00,249,121,128,Bewölkt,-1,-6,0,
,2021-01-26 12:00:00,313,163,150,Bewölkt,-1,-6,0,
,2021-01-26 13:00:00,297,146,151,Bewölkt,0,-5,0,
,2021-01-26 14:00:00,315,163,152,Leicht bewölkt,0,-5,0,
,2021-01-26 15:00:00,329,160,169,Leicht bewölkt,0,-5,0,
,2021-01-26 16:00:00,385,202,183,Leicht bewölkt,0,-5,0,
,2021-01-26 17:00:00,409,212,197,Leicht bewölkt,-1,-5,0,
,2021-01-26 18:00:00,310,136,174,Leicht bewölkt,-1,-6,0,
,2021-01-26 19:00:00,197,99,98,Leicht bewölkt,-2,-6,0,
,2021-01-26 20:00:00,71,29,42,Bewölkt,-2,-6,0,
,2021-01-26 21:00:00,27,10,17,Bewölkt,-2,-6,0,
,2021-01-26 22:00:00,15,5,10,Bewölkt,-3,-6,0,
,2021-01-26 23:00:00,9,5,4,Bedeckt,-4,-7,0,
,2021-01-27 00:00:00,4,2,2,Bedeckt,-5,-8,0,
,2021-01-27 01:00:00,1,1,0,Bedeckt,-5,-8,0,
,2021-01-27 02:00:00,1,0,1,Leicht bewölkt,-6,-9,0,
,2021-01-27 03:00:00,0,0,0,Leicht bewölkt,-6,-9,0,
,2021-01-27 04:00:00,7,5,2,Leicht bewölkt,-6,-8,0,
,2021-01-27 05:00:00,25,18,7,Bedeckt,-6,-8,0,
,2021-01-27 06:00:00,96,55,41,Bedeckt,-6,-8,0,
,2021-01-27 07:00:00,278,150,128,Bedeckt,-5,-7,0,
,2021-01-27 08:00:00,393,226,167,Bewölkt,-4,-6,0,
,2021-01-27 09:00:00,261,139,122,Bewölkt,-3,-5,0,
,2021-01-27 10:00:00,207,94,113,Bewölkt,-3,-5,0,
,2021-01-27 11:00:00,137,63,74,Bewölkt,-2,-4,0,
,2021-01-27 12:00:00,172,80,92,Bewölkt,-1,-4,0,
,2021-01-27 13:00:00,175,86,89,Bewölkt,0,-4,0,
,2021-01-27 14:00:00,172,82,90,Mäßiger Schneefall,0,-4,0.2,
,2021-01-27 15:00:00,231,111,120,Mäßiger Schneefall,0,-4,0.3,
,2021-01-27 16:00:00,286,156,130,Mäßiger Schneefall,0,-3,0.1,
,2021-01-27 17:00:00,293,146,147,Starker Schneefall,-1,-3,0.5,
,2021-01-27 18:00:00,230,108,122,Starker Schneefall,-2,-3,0.7,
,2021-01-27 19:00:00,162,87,75,Starker Schneefall,-4,-4,0.3,
,2021-01-27 20:00:00,64,38,26,Starker Schneefall,-5,-5,0.9,
,2021-01-27 21:00:00,17,10,7,Starker Schneefall,-7,-7,1.2,
,2021-01-27 22:00:00,4,2,2,Starker Schneefall,-5,-6,0.6,
,2021-01-27 23:00:00,7,4,3,Nebel,-3,-4,0,
,2021-01-28 00:00:00,4,4,0,Nebel,-2,-3,0,
,2021-01-28 01:00:00,2,1,1,Nebel,0,-2,0,
,2021-01-28 02:00:00,1,1,0,Leichter Nebel,1,-1,0,
,2021-01-28 03:00:00,1,0,1,Leichter Nebel,2,0,0,
,2021-01-28 04:00:00,4,2,2,Leichter Nebel,2,0,0,
,2021-01-28 05:00:00,21,12,9,Leichter Nebel,2,-1,0.5,
,2021-01-28 06:00:00,71,41,30,Leichter Nebel,2,-1,0.7,
,2021-01-28 07:00:00,223,127,96,Leichter Nebel,2,-1,0.3,
,2021-01-28 08:00:00,319,163,156,Leichter Regenfall,2,-1,1,
,2021-01-28 09:00:00,165,92,73,Leichter Regenfall,2,-2,1.3,
,2021-01-28 10:00:00,120,59,61,Leichter Regenfall,2,-1,0.7,
,2021-01-28 11:00:00,114,53,61,Mäßiger Regenfall,2,-1,1.8,
,2021-01-28 12:00:00,189,92,97,Mäßiger Regenfall,3,-1,2.4,
,2021-01-28 13:00:00,228,115,113,Mäßiger Regenfall,3,0,1.2,
,2021-01-28 14:00:00,279,153,126,Mäßiger Regenfall,4,0,1.8,
,2021-01-28 15:00:00,251,115,136,Mäßiger Regenfall,4,0,2.4,
,2021-01-28 16:00:00,388,189,199,Mäßiger Regenfall,4,1,1.2,
,2021-01-28 17:00:00,327,150,177,Mäßiger Regenfall,3,1,0.6,
,2021-01-28 18:00:00,274,129,145,Mäßiger Regenfall,3,1,0.8,
,2021-01-28 19:00:00,192,89,103,Mäßiger Regenfall,1,0,0.4,
,2021-01-28 20:00:00,91,40,51,Bedeckt,0,-1,0.6,
,2021-01-28 21:00:00,23,12,11,Bedeckt,-2,-2,0.8,
,2021-01-28 22:00:00,16,7,9,Bedeckt,0,-1,0.4,
,2021-01-28 23:00:00,5,1,4,Leichter Regenfall,2,0,0.2,
,2021-01-29 00:00:00,4,3,1,Leichter Regenfall,3,1,0.5,
,2021-01-29 01:00:00,1,1,0,Leichter Regenfall,4,1,0.2,
,2021-01-29 02:00:00,3,1,2,Leichter Regenschauer,4,2,0.2,
,2021-01-29 03:00:00,2,1,1,Leichter Regenschauer,5,2,0.2,
,2021-01-29 04:00:00,6,4,2,Leichter Regenschauer,5,2,0.1,
,2021-01-29 05:00:00,20,9,11,Nieselregen,4,2,0.5,
,2021-01-29 06:00:00,68,41,27,Nieselregen,4,2,0.6,
,2021-01-29 07:00:00,270,160,110,Nieselregen,4,2,0.3,
,2021-01-29 08:00:00,304,148,156,Leichter Regenfall,4,2,1.6,
,2021-01-29 09:00:00,278,146,132,Leichter Regenfall,4,2,2.2,
,2021-01-29 10:00:00,295,176,119,Leichter Regenfall,5,2,1.1,
,2021-01-29 11:00:00,322,146,176,Mäßiger Regenfall,5,2,2.1,
,2021-01-29 12:00:00,337,147,190,Mäßiger Regenfall,6,3,2.8,
,2021-01-29 13:00:00,283,132,151,Mäßiger Regenfall,6,3,1.4,
,2021-01-29 14:00:00,269,125,144,Mäßiger Regenfall,6,2,0.9,
,2021-01-29 15:00:00,265,124,141,Mäßiger Regenfall,6,2,1.2,
,2021-01-29 16:00:00,307,135,172,Mäßiger Regenfall,6,2,0.6,
,2021-01-29 17:00:00,288,124,164,Leichter Regenschauer,5,1,0.8,
,2021-01-29 18:00:00,201,87,114,Leichter Regenschauer,5,1,1,
,2021-01-29 19:00:00,192,93,99,Leichter Regenschauer,4,1,0.5,
,2021-01-29 20:00:00,72,34,38,Mäßiger bis starker Regen mit Gewitter,3,0,0.8,
,2021-01-29 21:00:00,22,17,5,Mäßiger bis starker Regen mit Gewitter,1,0,1.1,
,2021-01-29 22:00:00,15,9,6,Mäßiger bis starker Regen mit Gewitter,2,0,0.6,
,2021-01-29 23:00:00,10,6,4,Leichter Regenfall,2,0,0.3,
,2021-01-30 00:00:00,5,2,3,Leichter Regenfall,3,-1,0.7,
,2021-01-30 01:00:00,4,3,1,Leichter Regenfall,3,0,0.3,
,2021-01-30 02:00:00,2,0,2,Leichter Regenfall,4,0,0.2,
,2021-01-30 03:00:00,4,3,1,Leichter Regenfall,4,0,0.2,
,2021-01-30 04:00:00,5,2,3,Leichter Regenfall,3,0,0.1,
,2021-01-30 05:00:00,13,8,5,Stellenweiser Nieselregen,3,0,0,
,2021-01-30 06:00:00,23,12,11,Stellenweiser Nieselregen,3,-1,0,
,2021-01-30 07:00:00,31,19,12,Stellenweiser Nieselregen,3,0,0,
,2021-01-30 08:00:00,81,48,33,Bedeckt,3,1,0,
,2021-01-30 09:00:00,182,88,94,Bedeckt,3,1,0,
,2021-01-30 10:00:00,342,166,176,Bedeckt,3,2,0,
,2021-01-30 11:00:00,313,164,149,Stellenweiser Regenfall,4,2,0.3,
,2021-01-30 12:00:00,319,145,174,Stellenweiser Regenfall,4,3,0.4,
,2021-01-30 13:00:00,202,91,111,Stellenweiser Regenfall,4,3,0.2,
,2021-01-30 14:00:00,174,87,87,Leichter Regenfall,4,3,0.7,
,2021-01-30 15:00:00,183,83,100,Leichter Regenfall,4,3,1,
,2021-01-30 16:00:00,146,70,76,Leichter Regenfall,3,2,0.5,
,2021-01-30 17:00:00,148,70,78,Mäßiger Regenfall,2,1,0.7,
,2021-01-30 18:00:00,151,77,74,Mäßiger Regenfall,1,1,0.9,
,2021-01-30 19:00:00,174,80,94,Mäßiger Regenfall,0,-1,0.4,
,2021-01-30 20:00:00,68,37,31,Leichter Regenfall,-2,-2,0.9,
,2021-01-30 21:00:00,31,18,13,Leichter Regenfall,-3,-3,1.2,
,2021-01-30 22:00:00,12,4,8,Leichter Regenfall,-1,-2,0.6,
,2021-01-30 23:00:00,13,5,8,Leichter Regenfall,0,0,0.3,
,2021-01-31 00:00:00,14,7,7,Leichter Regenfall,2,1,0.5,
,2021-01-31 01:00:00,3,0,3,Leichter Regenfall,3,2,0.3,
,2021-01-31 02:00:00,4,2,2,Leichter Nebel,4,3,0.2,
,2021-01-31 03:00:00,5,3,2,Leichter Nebel,5,4,0.2,
,2021-01-31 04:00:00,2,2,0,Leichter Nebel,5,4,0.1,
,2021-01-31 05:00:00,8,3,5,Leichter Regenfall,5,3,0.1,
,2021-01-31 06:00:00,16,10,6,Leichter Regenfall,4,3,0.2,
,2021-01-31 07:00:00,15,7,8,Leichter Regenfall,4,3,0.1,
,2021-01-31 08:00:00,30,18,12,Nieselregen,4,4,0.2,
,2021-01-31 09:00:00,73,46,27,Nieselregen,4,4,0.2,
,2021-01-31 10:00:00,101,46,55,Nieselregen,4,4,0.1,
,2021-01-31 11:00:00,113,50,63,Nieselregen,4,4,0.3,
,2021-01-31 12:00:00,140,69,71,Nieselregen,5,5,0.4,
,2021-01-31 13:00:00,180,74,106,Nieselregen,5,5,0.2,
,2021-01-31 14:00:00,237,102,135,Leichter Regenfall,5,5,0.2,
,2021-01-31 15:00:00,217,108,109,Leichter Regenfall,5,5,0.2,
,2021-01-31 16:00:00,210,90,120,Leichter Regenfall,4,4,0.1,
,2021-01-31 17:00:00,182,94,88,Nieselregen,4,4,0.3,
,2021-01-31 18:00:00,128,69,59,Nieselregen,4,4,0.4,
,2021-01-31 19:00:00,150,72,78,Nieselregen,4,3,0.2,
,2021-01-31 20:00:00,44,23,21,Leichter Regenfall,4,3,0.2,
,2021-01-31 21:00:00,18,6,12,Leichter Regenfall,4,3,0.3,
,2021-01-31 22:00:00,16,10,6,Leichter Regenfall,3,2,0.1,
,2021-01-31 23:00:00,10,5,5,Bewölkt,2,1,0,
,2021-02-01 00:00:00,9,5,4,Bewölkt,2,1,0,
,2021-02-01 01:00:00,4,4,0,Bewölkt,2,1,0,
,2021-02-01 02:00:00,2,1,1,Bedeckt,3,2,0,
,2021-02-01 03:00:00,3,2,1,Bedeckt,3,2,0,
,2021-02-01 04:00:00,12,7,5,Bedeckt,3,2,0,
,2021-02-01 05:00:00,25,13,12,Bedeckt,3,2,0,
,2021-02-01 06:00:00,96,61,35,Bedeckt,3,3,0,
,2021-02-01 07:00:00,287,159,128,Bedeckt,3,3,0,
,2021-02-01 08:00:00,429,225,204,Stellenweiser Regenfall,3,3,0,
,2021-02-01 09:00:00,272,180,92,Stellenweiser Regenfall,4,3,0,
,2021-02-01 10:00:00,228,113,115,Stellenweiser Regenfall,4,4,0,
,2021-02-01 11:00:00,244,116,128,Bedeckt,5,4,0,
,2021-02-01 12:00:00,307,149,158,Bedeckt,5,4,0,
,2021-02-01 13:00:00,312,137,175,Bedeckt,5,4,0,
,2021-02-01 14:00:00,299,150,149,Bedeckt,5,3,0.6,
,2021-02-01 15:00:00,351,159,192,Bedeckt,5,3,0.8,
,2021-02-01 16:00:00,444,232,212,Bedeckt,4,2,0.4,
,2021-02-01 17:00:00,447,197,250,Mäßiger Regenfall,3,2,1.1,
,2021-02-01 18:00:00,292,136,156,Mäßiger Regenfall,2,1,1.4,
,2021-02-01 19:00:00,239,105,134,Mäßiger Regenfall,0,0,0.7,
,2021-02-01 20:00:00,76,36,40,Mäßiger Regenfall,-1,-1,0.5,
,2021-02-01 21:00:00,32,15,17,Mäßiger Regenfall,-2,-2,0.6,
,2021-02-01 22:00:00,12,5,7,Mäßiger Regenfall,0,-1,0.3,
,2021-02-01 23:00:00,17,9,8,Mäßiger Regenfall,2,0,1.2,
,2021-02-02 00:00:00,5,3,2,Mäßiger Regenfall,4,1,2.3,
,2021-02-02 01:00:00,9,6,3,Mäßiger Regenfall,4,2,1.2,
,2021-02-02 02:00:00,0,0,0,Teilweise mäßiger Regenfall,5,2,0.5,
,2021-02-02 03:00:00,1,1,0,Teilweise mäßiger Regenfall,5,2,0.6,
,2021-02-02 04:00:00,7,2,5,Teilweise mäßiger Regenfall,5,2,0.3,
,2021-02-02 05:00:00,34,20,14,Stellenweiser Nieselregen,4,2,0,
,2021-02-02 06:00:00,112,67,45,Stellenweiser Nieselregen,4,2,0,
,2021-02-02 07:00:00,340,189,151,Stellenweiser Nieselregen,5,3,0,
,2021-02-02 08:00:00,487,283,204,Bedeckt,5,3,0,
,2021-02-02 09:00:00,318,183,135,Bedeckt,6,4,0,
,2021-02-02 10:00:00,283,160,123,Bedeckt,7,5,0,
,2021-02-02 11:00:00,291,141,150,Bedeckt,8,6,0,
,2021-02-02 12:00:00,417,196,221,Bedeckt,8,7,0,
,2021-02-02 13:00:00,378,186,192,Bedeckt,9,7,0,
,2021-02-02 14:00:00,397,186,211,Bedeckt,9,7,0,
,2021-02-02 15:00:00,424,201,223,Bedeckt,9,7,0,
,2021-02-02 16:00:00,479,215,264,Bedeckt,8,7,0,
,2021-02-02 17:00:00,475,224,251,Leicht bewölkt,8,6,0,
,2021-02-02 18:00:00,364,180,184,Leicht bewölkt,8,6,0,
,2021-02-02 19:00:00,257,118,139,Leicht bewölkt,7,6,0,
,2021-02-02 20:00:00,102,49,53,Bedeckt,7,6,0.6,
,2021-02-02 21:00:00,19,9,10,Bedeckt,7,6,0.8,
,2021-02-02 22:00:00,22,9,13,Bedeckt,6,5,0.4,
,2021-02-02 23:00:00,13,5,8,Nieselregen,6,5,0,
,2021-02-03 00:00:00,5,1,4,Nieselregen,5,4,0.1,
,2021-02-03 01:00:00,5,3,2,Nieselregen,6,4,0,
,2021-02-03 02:00:00,2,1,1,Leicht bewölkt,6,4,0.3,
,2021-02-03 03:00:00,2,1,1,Leicht bewölkt,6,5,0.4,
,2021-02-03 04:00:00,6,3,3,Leicht bewölkt,6,4,0.2,
,2021-02-03 05:00:00,28,15,13,Stellenweiser leichter Regenfall,6,4,0.2,
,2021-02-03 06:00:00,108,60,48,Stellenweiser leichter Regenfall,5,4,0.3,
,2021-02-03 07:00:00,295,167,128,Stellenweiser leichter Regenfall,6,4,0.1,
,2021-02-03 08:00:00,388,202,186,Nieselregen,6,5,0,
,2021-02-03 09:00:00,221,127,94,Nieselregen,7,5,0,
,2021-02-03 10:00:00,164,77,87,Nieselregen,7,6,0,
,2021-02-03 11:00:00,158,67,91,Leicht bewölkt,8,7,0,
,2021-02-03 12:00:00,201,92,109,Leicht bewölkt,8,7,0,
,2021-02-03 13:00:00,272,116,156,Leicht bewölkt,8,7,0,
,2021-02-03 14:00:00,228,104,124,Leicht bewölkt,8,7,0.6,
,2021-02-03 15:00:00,205,87,118,Leicht bewölkt,8,7,0.8,
,2021-02-03 16:00:00,295,132,163,Leicht bewölkt,8,6,0.4,
,2021-02-03 17:00:00,349,150,199,Stellenweiser leichter Regenfall,8,6,0.3,
,2021-02-03 18:00:00,245,107,138,Stellenweiser leichter Regenfall,8,6,0.4,
,2021-02-03 19:00:00,171,82,89,Stellenweiser leichter Regenfall,8,5,0.2,
,2021-02-03 20:00:00,78,37,41,Bewölkt,7,4,0,
,2021-02-03 21:00:00,23,12,11,Bewölkt,6,3,0,
,2021-02-03 22:00:00,17,9,8,Bewölkt,6,3,0,
,2021-02-03 23:00:00,6,2,4,Stellenweiser Regenfall,6,3,0,
,2021-02-04 00:00:00,5,1,4,Stellenweiser Regenfall,6,3,0,
,2021-02-04 01:00:00,1,1,0,Stellenweiser Regenfall,5,3,0,
,2021-02-04 02:00:00,2,2,0,Leicht bewölkt,5,3,0,
,2021-02-04 03:00:00,1,0,1,Leicht bewölkt,5,3,0,
,2021-02-04 04:00:00,9,6,3,Leicht bewölkt,5,3,0,
,2021-02-04 05:00:00,36,23,13,Leicht bewölkt,5,3,0,
,2021-02-04 06:00:00,103,53,50,Leicht bewölkt,4,4,0,
,2021-02-04 07:00:00,308,172,136,Leicht bewölkt,5,4,0,
,2021-02-04 08:00:00,436,245,191,Leicht bewölkt,6,5,0,
,2021-02-04 09:00:00,305,165,140,Leicht bewölkt,6,6,0,
,2021-02-04 10:00:00,337,174,163,Leicht bewölkt,7,7,0,
,2021-02-04 11:00:00,398,205,193,Bedeckt,8,8,0,
,2021-02-04 12:00:00,455,215,240,Bedeckt,9,9,0,
,2021-02-04 13:00:00,536,262,274,Bedeckt,9,9,0,
,2021-02-04 14:00:00,529,261,268,Bedeckt,10,9,0,
,2021-02-04 15:00:00,574,249,325,Bedeckt,10,10,0,
,2021-02-04 16:00:00,639,316,323,Bedeckt,9,9,0,
,2021-02-04 17:00:00,610,295,315,Bedeckt,8,8,0,
,2021-02-04 18:00:00,376,165,211,Bedeckt,8,7,0,
,2021-02-04 19:00:00,301,129,172,Bedeckt,7,7,0,
,2021-02-04 20:00:00,109,45,64,Bewölkt,6,6,0,
,2021-02-04 21:00:00,36,18,18,Bewölkt,6,6,0,
,2021-02-04 22:00:00,26,14,12,Bewölkt,5,5,0,
,2021-02-04 23:00:00,4,1,3,Bedeckt,5,4,0,
,2021-02-05 00:00:00,3,3,0,Bedeckt,5,4,0,
,2021-02-05 01:00:00,1,1,0,Bedeckt,4,4,0,
,2021-02-05 02:00:00,2,1,1,Leicht bewölkt,4,3,0,
,2021-02-05 03:00:00,1,0,1,Leicht bewölkt,4,3,0,
,2021-02-05 04:00:00,3,2,1,Leicht bewölkt,4,3,0,
,2021-02-05 05:00:00,32,17,15,Leicht bewölkt,4,3,0,
,2021-02-05 06:00:00,113,69,44,Leicht bewölkt,4,4,0,
,2021-02-05 07:00:00,319,177,142,Leicht bewölkt,5,4,0,
,2021-02-05 08:00:00,512,304,208,Leicht bewölkt,5,5,0,
,2021-02-05 09:00:00,379,227,152,Leicht bewölkt,6,6,0,
,2021-02-05 10:00:00,393,210,183,Leicht bewölkt,7,7,0,
,2021-02-05 11:00:00,468,229,239,Leicht bewölkt,8,8,0,
,2021-02-05 12:00:00,520,217,303,Leicht bewölkt,9,9,0,
,2021-02-05 13:00:00,571,249,322,Leicht bewölkt,9,9,0,
,2021-02-05 14:00:00,608,298,310,Leicht bewölkt,10,10,0,
,2021-02-05 15:00:00,611,288,323,Leicht bewölkt,10,10,0,
,2021-02-05 16:00:00,602,270,332,Leicht bewölkt,9,9,0,
,2021-02-05 17:00:00,540,248,292,Bedeckt,9,8,0,
,2021-02-05 18:00:00,362,167,195,Bedeckt,8,8,0,
,2021-02-05 19:00:00,313,156,157,Bedeckt,8,7,0,
,2021-02-05 20:00:00,102,54,48,Bedeckt,7,7,0,
,2021-02-05 21:00:00,38,23,15,Bedeckt,7,6,0,
,2021-02-05 22:00:00,16,9,7,Bedeckt,6,6,0,
,2021-02-05 23:00:00,18,9,9,Leicht bewölkt,6,5,0,
,2021-02-06 00:00:00,7,5,2,Leicht bewölkt,6,5,0,
,2021-02-06 01:00:00,1,1,0,Leicht bewölkt,5,5,0,
,2021-02-06 02:00:00,2,0,2,Leicht bewölkt,5,5,0,
,2021-02-06 03:00:00,3,0,3,Leicht bewölkt,5,5,0,
,2021-02-06 04:00:00,6,4,2,Leicht bewölkt,5,4,0,
,2021-02-06 05:00:00,18,12,6,Leicht bewölkt,5,4,0,
,2021-02-06 06:00:00,41,21,20,Leicht bewölkt,5,4,0,
,2021-02-06 07:00:00,39,22,17,Leicht bewölkt,5,5,0,
,2021-02-06 08:00:00,110,67,43,Leicht bewölkt,6,6,0,
,2021-02-06 09:00:00,212,112,100,Leicht bewölkt,7,7,0,
,2021-02-06 10:00:00,328,156,172,Leicht bewölkt,8,8,0,
,2021-02-06 11:00:00,368,170,198,Leicht bewölkt,10,9,0,
,2021-02-06 12:00:00,457,210,247,Leicht bewölkt,11,11,0,
,2021-02-06 13:00:00,429,219,210,Leicht bewölkt,11,11,0,
,2021-02-06 14:00:00,444,234,210,Leicht bewölkt,12,11,0,
,2021-02-06 15:00:00,430,198,232,Leicht bewölkt,12,12,0,
,2021-02-06 16:00:00,341,161,180,Leicht bewölkt,11,11,0,
,2021-02-06 17:00:00,300,140,160,Leicht bewölkt,10,10,0,
,2021-02-06 18:00:00,211,114,97,Leicht bewölkt,10,9,0,
,2021-02-06 19:00:00,226,112,114,Leicht bewölkt,9,9,0,
,2021-02-06 20:00:00,79,52,27,Leicht bewölkt,8,8,0,
,2021-02-06 21:00:00,36,20,16,Leicht bewölkt,7,7,0,
,2021-02-06 22:00:00,15,9,6,Leicht bewölkt,7,6,0,
,2021-02-06 23:00:00,16,7,9,Leicht bewölkt,6,5,0,
,2021-02-07 00:00:00,8,4,4,Leicht bewölkt,6,4,0,
,2021-02-07 01:00:00,4,3,1,Leicht bewölkt,6,4,0,
,2021-02-07 02:00:00,3,2,1,Leicht bewölkt,5,4,0,
,2021-02-07 03:00:00,1,1,0,Leicht bewölkt,5,5,0,
,2021-02-07 04:00:00,2,1,1,Leicht bewölkt,5,4,0,
,2021-02-07 05:00:00,11,6,5,Leicht bewölkt,5,4,0,
,2021-02-07 06:00:00,17,12,5,Leicht bewölkt,5,3,0,
,2021-02-07 07:00:00,23,12,11,Leicht bewölkt,5,4,0,
,2021-02-07 08:00:00,35,14,21,Leicht bewölkt,5,4,0,
,2021-02-07 09:00:00,109,63,46,Leicht bewölkt,6,5,0,
,2021-02-07 10:00:00,149,70,79,Leicht bewölkt,6,5,0,
,2021-02-07 11:00:00,193,99,94,Bedeckt,7,5,0,
,2021-02-07 12:00:00,192,84,108,Bedeckt,7,6,0,
,2021-02-07 13:00:00,212,103,109,Bedeckt,7,5,0,
,2021-02-07 14:00:00,161,75,86,Bedeckt,7,5,0.3,
,2021-02-07 15:00:00,138,78,60,Bedeckt,6,4,0.4,
,2021-02-07 16:00:00,142,80,62,Bedeckt,6,3,0.2,
,2021-02-07 17:00:00,119,55,64,Leichter Regenfall,5,2,0.1,
,2021-02-07 18:00:00,117,57,60,Leichter Regenfall,4,1,0.2,
,2021-02-07 19:00:00,146,81,65,Leichter Regenfall,4,1,0.1,
,2021-02-07 20:00:00,58,32,26,Bedeckt,4,1,0.1,
,2021-02-07 21:00:00,23,8,15,Bedeckt,3,1,0.2,
,2021-02-07 22:00:00,7,5,2,Bedeckt,3,0,0.1,
,2021-02-07 23:00:00,7,3,4,Stellenweise starker Schneefall,2,0,0.3,
,2021-02-08 00:00:00,1,0,1,Stellenweise starker Schneefall,2,0,0.6,
,2021-02-08 01:00:00,2,2,0,Stellenweise starker Schneefall,2,0,0.3,
,2021-02-08 02:00:00,1,0,1,Leicht bewölkt,2,1,0,
,2021-02-08 03:00:00,4,2,2,Leicht bewölkt,2,1,0,
,2021-02-08 04:00:00,12,7,5,Leicht bewölkt,1,0,0,
,2021-02-08 05:00:00,44,30,14,Bedeckt,1,0,0,
,2021-02-08 06:00:00,113,66,47,Bedeckt,1,0,0,
,2021-02-08 07:00:00,323,180,143,Bedeckt,2,0,0,
,2021-02-08 08:00:00,479,247,232,Leicht bewölkt,2,1,0,
,2021-02-08 09:00:00,298,160,138,Leicht bewölkt,3,1,0,
,2021-02-08 10:00:00,299,170,129,Leicht bewölkt,3,2,0,
,2021-02-08 11:00:00,341,162,179,Leicht bewölkt,4,3,0,
,2021-02-08 12:00:00,412,195,217,Leicht bewölkt,5,4,0,
,2021-02-08 13:00:00,446,219,227,Leicht bewölkt,6,5,0,
,2021-02-08 14:00:00,400,197,203,Leicht bewölkt,6,5,0,
,2021-02-08 15:00:00,381,193,188,Leicht bewölkt,6,6,0,
,2021-02-08 16:00:00,456,203,253,Leicht bewölkt,6,5,0,
,2021-02-08 17:00:00,468,217,251,Leicht bewölkt,5,4,0,
,2021-02-08 18:00:00,339,167,172,Leicht bewölkt,4,3,0,
,2021-02-08 19:00:00,245,116,129,Leicht bewölkt,4,3,0,
,2021-02-08 20:00:00,102,53,49,Leicht bewölkt,3,2,0,
,2021-02-08 21:00:00,30,15,15,Leicht bewölkt,3,1,0,
,2021-02-08 22:00:00,18,8,10,Leicht bewölkt,2,1,0,
,2021-02-08 23:00:00,4,1,3,Stellenweise leichter Schneefall,2,1,0,
,2021-02-09 00:00:00,2,1,1,Stellenweise leichter Schneefall,1,1,0,
,2021-02-09 01:00:00,3,3,0,Stellenweise leichter Schneefall,1,1,0,
,2021-02-09 02:00:00,2,0,2,Nebel,1,1,0.3,
,2021-02-09 03:00:00,3,3,0,Nebel,1,1,0.4,
,2021-02-09 04:00:00,7,3,4,Nebel,1,1,0.2,
,2021-02-09 05:00:00,21,14,7,Starker Schneefall,1,0,1.1,
,2021-02-09 06:00:00,110,68,42,Starker Schneefall,0,-1,1.4,
,2021-02-09 07:00:00,252,133,119,Starker Schneefall,1,-1,0.7,
,2021-02-09 08:00:00,324,162,162,Starker Schneefall,1,-1,0.9,
,2021-02-09 09:00:00,191,110,81,Starker Schneefall,1,-1,1.2,
,2021-02-09 10:00:00,158,79,79,Starker Schneefall,1,-1,0.6,
,2021-02-09 11:00:00,206,114,92,Starker Schneefall,2,0,0.8,
,2021-02-09 12:00:00,273,126,147,Starker Schneefall,3,0,1,
,2021-02-09 13:00:00,296,136,160,Starker Schneefall,3,0,0.5,
,2021-02-09 14:00:00,288,134,154,Stellenweise starker Schneefall,3,1,0.3,
,2021-02-09 15:00:00,371,187,184,Stellenweise starker Schneefall,3,1,0.4,
,2021-02-09 16:00:00,418,209,209,Stellenweise starker Schneefall,3,1,0.2,
,2021-02-09 17:00:00,466,236,230,Stellenweiser Regenfall,3,2,0,
,2021-02-09 18:00:00,329,143,186,Stellenweiser Regenfall,3,2,0,
,2021-02-09 19:00:00,218,102,116,Stellenweiser Regenfall,3,2,0,
,2021-02-09 20:00:00,83,31,52,Leichter Nebel,3,2,0,
,2021-02-09 21:00:00,31,15,16,Leichter Nebel,3,1,0,
,2021-02-09 22:00:00,20,13,7,Leichter Nebel,2,0,0,
,2021-02-09 23:00:00,16,9,7,Bewölkt,0,-1,0,
,2021-02-10 00:00:00,6,4,2,Bewölkt,-1,-2,0,
,2021-02-10 01:00:00,4,3,1,Bewölkt,0,-2,0,
,2021-02-10 02:00:00,0,0,0,Bedeckt,0,-2,0,
,2021-02-10 03:00:00,5,3,2,Bedeckt,0,-2,0,
,2021-02-10 04:00:00,5,3,2,Bedeckt,0,-1,0,
,2021-02-10 05:00:00,29,21,8,Bedeckt,1,-1,0,
,2021-02-10 06:00:00,89,53,36,Bedeckt,1,-1,0,
,2021-02-10 07:00:00,273,141,132,Bedeckt,1,-1,0,
,2021-02-10 08:00:00,346,200,146,Leicht bewölkt,1,-1,0.1,
,2021-02-10 09:00:00,208,108,100,Leicht bewölkt,1,-1,0.2,
,2021-02-10 10:00:00,185,94,91,Leicht bewölkt,2,0,0.1,
,2021-02-10 11:00:00,171,96,75,Starker Schneefall,2,1,0.1,
,2021-02-10 12:00:00,250,113,137,Starker Schneefall,2,1,0.1,
,2021-02-10 13:00:00,314,164,150,Starker Schneefall,2,1,0,
,2021-02-10 14:00:00,327,150,177,Nebel,2,1,0.3,
,2021-02-10 15:00:00,267,119,148,Nebel,3,1,0.4,
,2021-02-10 16:00:00,291,148,143,Nebel,2,1,0.2,
,2021-02-10 17:00:00,303,127,176,Leichter Eisregen,2,1,0.3,
,2021-02-10 18:00:00,226,100,126,Leichter Eisregen,1,0,0.4,
,2021-02-10 19:00:00,163,85,78,Leichter Eisregen,0,-1,0.2,
,2021-02-10 20:00:00,68,35,33,Starker Schneefall,-1,-1,0.8,
,2021-02-10 21:00:00,22,10,12,Starker Schneefall,-2,-2,1,
,2021-02-10 22:00:00,20,11,9,Starker Schneefall,-3,-5,0.5,
,2021-02-10 23:00:00,11,3,8,Starker Schneefall,-5,-8,0.6,
,2021-02-11 00:00:00,3,2,1,Starker Schneefall,-6,-11,1.3,
,2021-02-11 01:00:00,1,1,0,Starker Schneefall,-7,-12,0.6,
,2021-02-11 02:00:00,1,1,0,Starker Schneefall,-8,-13,0.3,
,2021-02-11 03:00:00,4,1,3,Starker Schneefall,-9,-14,0.4,
,2021-02-11 04:00:00,7,3,4,Starker Schneefall,-10,-15,0.2,
,2021-02-11 05:00:00,20,8,12,Starker Schneefall,-10,-16,0.2,
,2021-02-11 06:00:00,43,24,19,Starker Schneefall,-11,-17,0.3,
,2021-02-11 07:00:00,172,83,89,Starker Schneefall,-11,-16,0.1,
,2021-02-11 08:00:00,215,115,100,Starker Schneefall,-10,-15,0.1,
,2021-02-11 09:00:00,140,79,61,Starker Schneefall,-10,-15,0.1,
,2021-02-11 10:00:00,150,84,66,Starker Schneefall,-8,-13,0.1,
,2021-02-11 11:00:00,170,84,86,Stellenweise leichter Schneefall,-7,-12,0,
,2021-02-11 12:00:00,231,134,97,Stellenweise leichter Schneefall,-6,-11,0,
,2021-02-11 13:00:00,254,120,134,Stellenweise leichter Schneefall,-6,-11,0,
,2021-02-11 14:00:00,318,162,156,Stellenweise mäßiger Schneefall,-5,-10,0,
,2021-02-11 15:00:00,315,157,158,Stellenweise mäßiger Schneefall,-5,-10,0,
,2021-02-11 16:00:00,320,189,131,Stellenweise mäßiger Schneefall,-6,-11,0,
,2021-02-11 17:00:00,297,143,154,Sonnig,-7,-13,0,
,2021-02-11 18:00:00,221,112,109,Sonnig,-8,-14,0,
,2021-02-11 19:00:00,170,92,78,Sonnig,-8,-15,0,
,2021-02-11 20:00:00,104,40,64,Sonnig,-9,-15,0,
,2021-02-11 21:00:00,46,25,21,Sonnig,-10,-16,0,
,2021-02-11 22:00:00,40,20,20,Sonnig,-10,-16,0,
,2021-02-11 23:00:00,42,19,23,Leicht bewölkt,-10,-16,0,
,2021-02-12 00:00:00,30,11,19,Leicht bewölkt,-10,-15,0,
,2021-02-12 01:00:00,10,8,2,Leicht bewölkt,-10,-15,0,
,2021-02-12 02:00:00,7,4,3,Leicht bewölkt,-10,-15,0,
,2021-02-12 03:00:00,1,1,0,Leicht bewölkt,-10,-16,0,
,2021-02-12 04:00:00,4,2,2,Leicht bewölkt,-10,-16,0,
,2021-02-12 05:00:00,19,7,12,Leicht bewölkt,-10,-16,0,
,2021-02-12 06:00:00,58,32,26,Leicht bewölkt,-10,-16,0,
,2021-02-12 07:00:00,179,100,79,Leicht bewölkt,-9,-15,0,
,2021-02-12 08:00:00,270,167,103,Leicht bewölkt,-8,-14,0,
,2021-02-12 09:00:00,220,137,83,Leicht bewölkt,-7,-13,0,
,2021-02-12 10:00:00,234,129,105,Leicht bewölkt,-6,-12,0,
,2021-02-12 11:00:00,254,135,119,Bedeckt,-5,-11,0,
,2021-02-12 12:00:00,334,148,186,Bedeckt,-4,-9,0,
,2021-02-12 13:00:00,330,153,177,Bedeckt,-3,-9,0,
,2021-02-12 14:00:00,321,150,171,Bewölkt,-3,-9,0,
,2021-02-12 15:00:00,341,168,173,Bewölkt,-3,-9,0,
,2021-02-12 16:00:00,314,176,138,Bewölkt,-3,-10,0,
,2021-02-12 17:00:00,293,146,147,Leicht bewölkt,-4,-11,0,
,2021-02-12 18:00:00,240,119,121,Leicht bewölkt,-5,-12,0,
,2021-02-12 19:00:00,132,68,64,Leicht bewölkt,-5,-13,0,
,2021-02-12 20:00:00,97,47,50,Leicht bewölkt,-6,-14,0,
,2021-02-12 21:00:00,46,22,24,Leicht bewölkt,-7,-14,0,
,2021-02-12 22:00:00,30,11,19,Leicht bewölkt,-7,-15,0,
,2021-02-12 23:00:00,37,18,19,Leicht bewölkt,-8,-16,0,
,2021-02-13 00:00:00,18,7,11,Leicht bewölkt,-9,-17,0,
,2021-02-13 01:00:00,19,11,8,Leicht bewölkt,-9,-17,0,
,2021-02-13 02:00:00,9,8,1,Leicht bewölkt,-10,-18,0,
,2021-02-13 03:00:00,3,1,2,Leicht bewölkt,-10,-18,0,
,2021-02-13 04:00:00,6,2,4,Leicht bewölkt,-10,-18,0,
,2021-02-13 05:00:00,12,7,5,Sonnig,-10,-18,0,
,2021-02-13 06:00:00,17,9,8,Sonnig,-10,-18,0,
,2021-02-13 07:00:00,39,19,20,Sonnig,-9,-17,0,
,2021-02-13 08:00:00,79,48,31,Sonnig,-8,-16,0,
,2021-02-13 09:00:00,124,61,63,Sonnig,-8,-15,0,
,2021-02-13 10:00:00,151,81,70,Sonnig,-7,-14,0,
,2021-02-13 11:00:00,224,104,120,Sonnig,-6,-13,0,
,2021-02-13 12:00:00,200,110,90,Sonnig,-5,-12,0,
,2021-02-13 13:00:00,218,108,110,Sonnig,-4,-12,0,
,2021-02-13 14:00:00,227,107,120,Sonnig,-4,-11,0,
,2021-02-13 15:00:00,207,114,93,Sonnig,-4,-11,0,
,2021-02-13 16:00:00,217,119,98,Sonnig,-5,-12,0,
,2021-02-13 17:00:00,190,105,85,Sonnig,-6,-13,0,
,2021-02-13 18:00:00,158,80,78,Sonnig,-7,-15,0,
,2021-02-13 19:00:00,97,48,49,Sonnig,-7,-15,0,
,2021-02-13 20:00:00,86,43,43,Sonnig,-8,-16,0,
,2021-02-13 21:00:00,40,22,18,Sonnig,-9,-16,0,
,2021-02-13 22:00:00,30,20,10,Sonnig,-9,-16,0,
,2021-02-13 23:00:00,15,5,10,Sonnig,-9,-15,0,
,2021-02-14 00:00:00,22,10,12,Sonnig,-9,-15,0,
,2021-02-14 01:00:00,18,8,10,Sonnig,-9,-14,0,
,2021-02-14 02:00:00,9,1,8,Sonnig,-9,-14,0,
,2021-02-14 03:00:00,4,4,0,Sonnig,-9,-13,0,
,2021-02-14 04:00:00,10,8,2,Sonnig,-9,-13,0,
,2021-02-14 05:00:00,6,1,5,Sonnig,-9,-13,0,
,2021-02-14 06:00:00,13,10,3,Sonnig,-9,-12,0,
,2021-02-14 07:00:00,20,8,12,Sonnig,-8,-11,0,
,2021-02-14 08:00:00,30,15,15,Sonnig,-7,-10,0,
,2021-02-14 09:00:00,79,43,36,Sonnig,-6,-9,0,
,2021-02-14 10:00:00,91,42,49,Sonnig,-4,-7,0,
,2021-02-14 11:00:00,142,65,77,Leicht bewölkt,-2,-4,0,
,2021-02-14 12:00:00,145,72,73,Leicht bewölkt,0,-2,0,
,2021-02-14 13:00:00,189,95,94,Leicht bewölkt,1,-1,0,
,2021-02-14 14:00:00,193,101,92,Sonnig,2,0,0,
,2021-02-14 15:00:00,229,128,101,Sonnig,3,2,0,
,2021-02-14 16:00:00,234,116,118,Sonnig,2,1,0,
,2021-02-14 17:00:00,185,95,90,Leicht bewölkt,1,1,0,
,2021-02-14 18:00:00,142,81,61,Leicht bewölkt,0,0,0,
,2021-02-14 19:00:00,91,50,41,Leicht bewölkt,-1,-1,0,
,2021-02-14 20:00:00,66,26,40,Leicht bewölkt,-3,-3,0,
,2021-02-14 21:00:00,40,20,20,Leicht bewölkt,-4,-4,0,
,2021-02-14 22:00:00,28,11,17,Leicht bewölkt,-4,-4,0,
,2021-02-14 23:00:00,15,7,8,Bedeckt,-5,-5,0,
,2021-02-15 00:00:00,11,7,4,Bedeckt,-5,-5,0,
,2021-02-15 01:00:00,1,1,0,Bedeckt,-5,-5,0,
,2021-02-15 02:00:00,4,1,3,Leicht bewölkt,-5,-5,0,
,2021-02-15 03:00:00,4,1,3,Leicht bewölkt,-6,-6,0,
,2021-02-15 04:00:00,8,6,2,Leicht bewölkt,-6,-6,0,
,2021-02-15 05:00:00,26,16,10,Leicht bewölkt,-6,-6,0,
,2021-02-15 06:00:00,98,66,32,Leicht bewölkt,-6,-6,0,
,2021-02-15 07:00:00,258,143,115,Leicht bewölkt,-5,-5,0,
,2021-02-15 08:00:00,350,205,145,Bedeckt,-3,-3,0,
,2021-02-15 09:00:00,228,145,83,Bedeckt,-2,-2,0,
,2021-02-15 10:00:00,219,116,103,Bedeckt,-1,-1,0,
,2021-02-15 11:00:00,290,135,155,Bedeckt,1,1,0,
,2021-02-15 12:00:00,349,146,203,Bedeckt,2,2,0,
,2021-02-15 13:00:00,327,161,166,Bedeckt,3,2,0,
,2021-02-15 14:00:00,338,184,154,Bedeckt,3,3,0,
,2021-02-15 15:00:00,383,189,194,Bedeckt,3,3,0,
,2021-02-15 16:00:00,411,195,216,Bedeckt,3,3,0,
,2021-02-15 17:00:00,403,193,210,Bedeckt,2,2,0,
,2021-02-15 18:00:00,303,146,157,Bedeckt,2,1,0,
,2021-02-15 19:00:00,193,106,87,Bedeckt,0,0,0,
,2021-02-15 20:00:00,95,41,54,Bedeckt,-2,-2,0,
,2021-02-15 21:00:00,45,22,23,Bedeckt,-4,-4,0,
,2021-02-15 22:00:00,42,25,17,Bedeckt,-2,-2,0,
,2021-02-15 23:00:00,19,8,11,Leicht bewölkt,0,-1,0,
,2021-02-16 00:00:00,12,7,5,Leicht bewölkt,2,1,0,
,2021-02-16 01:00:00,6,3,3,Leicht bewölkt,2,1,0,
,2021-02-16 02:00:00,1,1,0,Bedeckt,2,1,0,
,2021-02-16 03:00:00,1,0,1,Bedeckt,2,1,0,
,2021-02-16 04:00:00,2,2,0,Bedeckt,2,1,0,
,2021-02-16 05:00:00,29,15,14,Nieselregen,2,1,0,
,2021-02-16 06:00:00,116,71,45,Nieselregen,2,2,0,
,2021-02-16 07:00:00,321,185,136,Nieselregen,3,2,0,
,2021-02-16 08:00:00,451,259,192,Bedeckt,3,3,0,
,2021-02-16 09:00:00,314,187,127,Bedeckt,4,4,0,
,2021-02-16 10:00:00,336,188,148,Bedeckt,5,5,0,
,2021-02-16 11:00:00,368,194,174,Bedeckt,6,6,0,
,2021-02-16 12:00:00,475,221,254,Bedeckt,7,7,0,
,2021-02-16 13:00:00,490,232,258,Bedeckt,7,7,0,
,2021-02-16 14:00:00,517,255,262,Leicht bewölkt,7,7,0,
,2021-02-16 15:00:00,527,270,257,Leicht bewölkt,8,8,0,
,2021-02-16 16:00:00,577,275,302,Leicht bewölkt,6,6,0,
,2021-02-16 17:00:00,613,318,295,Leicht bewölkt,5,5,0,
,2021-02-16 18:00:00,446,191,255,Leicht bewölkt,4,3,0,
,2021-02-16 19:00:00,263,132,131,Leicht bewölkt,4,2,0,
,2021-02-16 20:00:00,122,61,61,Leicht bewölkt,3,1,0,
,2021-02-16 21:00:00,67,36,31,Leicht bewölkt,2,0,0,
,2021-02-16 22:00:00,66,35,31,Leicht bewölkt,2,0,0,
,2021-02-16 23:00:00,35,17,18,Leicht bewölkt,2,0,0,
,2021-02-17 00:00:00,17,6,11,Leicht bewölkt,2,0,0,
,2021-02-17 01:00:00,4,3,1,Leicht bewölkt,3,1,0,
,2021-02-17 02:00:00,5,4,1,Bedeckt,3,1,0.4,
,2021-02-17 03:00:00,1,0,1,Bedeckt,3,1,0.5,
,2021-02-17 04:00:00,10,7,3,Bedeckt,4,1,0.2,
,2021-02-17 05:00:00,36,17,19,Leichter Regenfall,4,2,0.4,
,2021-02-17 06:00:00,137,81,56,Leichter Regenfall,4,2,0.6,
,2021-02-17 07:00:00,324,183,141,Leichter Regenfall,4,2,0.3,
,2021-02-17 08:00:00,507,289,218,Leichter Regenfall,5,3,0.2,
,2021-02-17 09:00:00,383,232,151,Leichter Regenfall,5,3,0.3,
,2021-02-17 10:00:00,368,179,189,Leichter Regenfall,6,4,0.2,
,2021-02-17 11:00:00,417,216,201,Stellenweiser Nieselregen,7,6,0.1,
,2021-02-17 12:00:00,524,232,292,Stellenweiser Nieselregen,8,7,0.2,
,2021-02-17 13:00:00,520,261,259,Stellenweiser Nieselregen,9,7,0.1,
,2021-02-17 14:00:00,603,306,297,Stellenweiser Regenfall,9,8,0.1,
,2021-02-17 15:00:00,619,312,307,Stellenweiser Regenfall,10,9,0.1,
,2021-02-17 16:00:00,686,354,332,Stellenweiser Regenfall,9,8,0,
,2021-02-17 17:00:00,683,337,346,Stellenweiser Regenfall,8,8,0,
,2021-02-17 18:00:00,537,259,278,Stellenweiser Regenfall,8,7,0,
,2021-02-17 19:00:00,258,125,133,Stellenweiser Regenfall,6,6,0,
,2021-02-17 20:00:00,182,79,103,Leicht bewölkt,5,4,0,
,2021-02-17 21:00:00,79,32,47,Leicht bewölkt,4,3,0,
,2021-02-17 22:00:00,68,33,35,Leicht bewölkt,3,2,0,
,2021-02-17 23:00:00,36,18,18,Leicht bewölkt,2,1,0,
,2021-02-18 00:00:00,21,9,12,Leicht bewölkt,2,1,0,
,2021-02-18 01:00:00,14,7,7,Leicht bewölkt,1,0,0,
,2021-02-18 02:00:00,6,4,2,Bedeckt,1,0,0,
,2021-02-18 03:00:00,2,0,2,Bedeckt,0,0,0,
,2021-02-18 04:00:00,12,9,3,Bedeckt,0,0,0,
,2021-02-18 05:00:00,39,21,18,Leicht bewölkt,0,0,0,
,2021-02-18 06:00:00,116,64,52,Leicht bewölkt,-1,-1,0,
,2021-02-18 07:00:00,362,208,154,Leicht bewölkt,1,1,0,
,2021-02-18 08:00:00,517,303,214,Bedeckt,2,2,0,
,2021-02-18 09:00:00,370,229,141,Bedeckt,3,3,0,
,2021-02-18 10:00:00,329,184,145,Bedeckt,5,4,0,
,2021-02-18 11:00:00,366,192,174,Leicht bewölkt,6,5,0,
,2021-02-18 12:00:00,504,230,274,Leicht bewölkt,7,7,0,
,2021-02-18 13:00:00,499,255,244,Leicht bewölkt,8,8,0,
,2021-02-18 14:00:00,567,275,292,Bedeckt,9,9,0,
,2021-02-18 15:00:00,629,325,304,Bedeckt,10,9,0,
,2021-02-18 16:00:00,736,353,383,Bedeckt,9,9,0,
,2021-02-18 17:00:00,688,324,364,Leicht bewölkt,9,8,0,
,2021-02-18 18:00:00,474,215,259,Leicht bewölkt,8,8,0,
,2021-02-18 19:00:00,251,116,135,Leicht bewölkt,7,6,0,
,2021-02-18 20:00:00,173,80,93,Leicht bewölkt,5,4,0,
,2021-02-18 21:00:00,84,43,41,Leicht bewölkt,4,3,0,
,2021-02-18 22:00:00,66,26,40,Leicht bewölkt,4,2,0,
,2021-02-18 23:00:00,52,26,26,Leicht bewölkt,3,1,0,
,2021-02-19 00:00:00,20,7,13,Leicht bewölkt,3,1,0,
,2021-02-19 01:00:00,9,6,3,Leicht bewölkt,3,1,0,
,2021-02-19 02:00:00,0,0,0,Leicht bewölkt,3,1,0,
,2021-02-19 03:00:00,4,2,2,Leicht bewölkt,3,1,0,
,2021-02-19 04:00:00,10,4,6,Leicht bewölkt,3,1,0,
,2021-02-19 05:00:00,33,16,17,Bedeckt,2,1,0,
,2021-02-19 06:00:00,121,86,35,Bedeckt,2,0,0,
,2021-02-19 07:00:00,311,178,133,Bedeckt,3,2,0,
,2021-02-19 08:00:00,478,279,199,Leicht bewölkt,5,3,0,
,2021-02-19 09:00:00,409,270,139,Leicht bewölkt,6,4,0,
,2021-02-19 10:00:00,403,218,185,Leicht bewölkt,7,6,0,
,2021-02-19 11:00:00,514,272,242,Leicht bewölkt,9,8,0,
,2021-02-19 12:00:00,553,218,335,Leicht bewölkt,11,11,0,
,2021-02-19 13:00:00,566,256,310,Leicht bewölkt,11,11,0,
,2021-02-19 14:00:00,645,307,338,Leicht bewölkt,12,12,0,
,2021-02-19 15:00:00,669,356,313,Leicht bewölkt,13,13,0,
,2021-02-19 16:00:00,681,326,355,Leicht bewölkt,12,12,0,
,2021-02-19 17:00:00,718,358,360,Leicht bewölkt,11,11,0,
,2021-02-19 18:00:00,484,231,253,Leicht bewölkt,10,10,0,
,2021-02-19 19:00:00,289,140,149,Leicht bewölkt,9,9,0,
,2021-02-19 20:00:00,139,66,73,Leicht bewölkt,7,7,0,
,2021-02-19 21:00:00,91,39,52,Leicht bewölkt,6,6,0,
,2021-02-19 22:00:00,72,38,34,Leicht bewölkt,6,5,0,
,2021-02-19 23:00:00,60,26,34,Leicht bewölkt,5,4,0,
,2021-02-20 00:00:00,44,26,18,Leicht bewölkt,5,4,0,
,2021-02-20 01:00:00,37,21,16,Leicht bewölkt,4,3,0,
,2021-02-20 02:00:00,19,7,12,Leicht bewölkt,4,2,0,
,2021-02-20 03:00:00,10,7,3,Leicht bewölkt,3,1,0,
,2021-02-20 04:00:00,25,18,7,Leicht bewölkt,3,1,0,
,2021-02-20 05:00:00,25,13,12,Leicht bewölkt,3,1,0,
,2021-02-20 06:00:00,42,24,18,Leicht bewölkt,3,1,0,
,2021-02-20 07:00:00,61,33,28,Leicht bewölkt,4,3,0,
,2021-02-20 08:00:00,157,91,66,Leicht bewölkt,5,4,0,
,2021-02-20 09:00:00,252,125,127,Leicht bewölkt,6,5,0,
,2021-02-20 10:00:00,353,186,167,Leicht bewölkt,8,8,0,
,2021-02-20 11:00:00,471,245,226,Leicht bewölkt,10,10,0,
,2021-02-20 12:00:00,599,278,321,Leicht bewölkt,12,12,0,
,2021-02-20 13:00:00,693,320,373,Leicht bewölkt,13,13,0,
,2021-02-20 14:00:00,735,362,373,Leicht bewölkt,14,15,0,
,2021-02-20 15:00:00,738,361,377,Leicht bewölkt,16,16,0,
,2021-02-20 16:00:00,642,344,298,Leicht bewölkt,15,15,0,
,2021-02-20 17:00:00,611,385,226,Sonnig,15,15,0,
,2021-02-20 18:00:00,443,235,208,Sonnig,14,14,0,
,2021-02-20 19:00:00,222,121,101,Sonnig,13,13,0,
,2021-02-20 20:00:00,154,74,80,Sonnig,12,12,0,
,2021-02-20 21:00:00,91,40,51,Sonnig,11,11,0,
,2021-02-20 22:00:00,53,27,26,Sonnig,9,9,0,
,2021-02-20 23:00:00,54,25,29,Sonnig,8,7,0,
,2021-02-21 00:00:00,51,32,19,Sonnig,6,6,0,
,2021-02-21 01:00:00,31,17,14,Sonnig,5,5,0,
,2021-02-21 02:00:00,9,3,6,Sonnig,5,4,0,
,2021-02-21 03:00:00,9,4,5,Sonnig,4,3,0,
,2021-02-21 04:00:00,5,4,1,Sonnig,3,3,0,
,2021-02-21 05:00:00,13,6,7,Sonnig,3,2,0,
,2021-02-21 06:00:00,20,16,4,Sonnig,3,2,0,
,2021-02-21 07:00:00,30,11,19,Sonnig,4,4,0,
,2021-02-21 08:00:00,62,26,36,Sonnig,6,5,0,
,2021-02-21 09:00:00,127,79,48,Sonnig,7,7,0,
,2021-02-21 10:00:00,188,81,107,Sonnig,9,9,0,
,2021-02-21 11:00:00,280,142,138,Sonnig,11,11,0,
,2021-02-21 12:00:00,424,173,251,Sonnig,13,13,0,
,2021-02-21 13:00:00,599,287,312,Sonnig,13,14,0,
,2021-02-21 14:00:00,675,379,296,Sonnig,14,14,0,
,2021-02-21 15:00:00,708,385,323,Sonnig,15,15,0,
,2021-02-21 16:00:00,681,388,293,Sonnig,14,14,0,
,2021-02-21 17:00:00,609,326,283,Sonnig,14,14,0,
,2021-02-21 18:00:00,341,171,170,Sonnig,13,13,0,
,2021-02-21 19:00:00,180,97,83,Sonnig,12,12,0,
,2021-02-21 20:00:00,96,46,50,Sonnig,11,11,0,
,2021-02-21 21:00:00,76,37,39,Sonnig,10,10,0,
,2021-02-21 22:00:00,47,33,14,Sonnig,9,8,0,
,2021-02-21 23:00:00,19,8,11,Sonnig,7,7,0,
,2021-02-22 00:00:00,17,13,4,Sonnig,6,5,0,
,2021-02-22 01:00:00,5,1,4,Sonnig,5,4,0,
,2021-02-22 02:00:00,2,0,2,Sonnig,4,3,0,
,2021-02-22 03:00:00,2,1,1,Sonnig,3,2,0,
,2021-02-22 04:00:00,6,5,1,Sonnig,3,2,0,
,2021-02-22 05:00:00,34,19,15,Sonnig,3,1,0,
,2021-02-22 06:00:00,172,112,60,Sonnig,2,1,0,
,2021-02-22 07:00:00,515,294,221,Sonnig,4,3,0,
,2021-02-22 08:00:00,702,396,306,Sonnig,5,5,0,
,2021-02-22 09:00:00,512,292,220,Sonnig,7,7,0,
,2021-02-22 10:00:00,423,241,182,Sonnig,9,8,0,
,2021-02-22 11:00:00,467,219,248,Sonnig,10,10,0,
,2021-02-22 12:00:00,608,285,323,Sonnig,12,12,0,
,2021-02-22 13:00:00,739,368,371,Sonnig,13,13,0,
,2021-02-22 14:00:00,756,411,345,Leicht bewölkt,13,13,0,
,2021-02-22 15:00:00,835,418,417,Leicht bewölkt,14,14,0,
,2021-02-22 16:00:00,871,417,454,Leicht bewölkt,13,13,0,
,2021-02-22 17:00:00,789,374,415,Leicht bewölkt,12,12,0,
,2021-02-22 18:00:00,575,242,333,Leicht bewölkt,11,11,0,
,2021-02-22 19:00:00,293,140,153,Leicht bewölkt,10,10,0,
,2021-02-22 20:00:00,141,68,73,Leicht bewölkt,9,9,0,
,2021-02-22 21:00:00,97,47,50,Leicht bewölkt,7,7,0,
,2021-02-22 22:00:00,77,34,43,Leicht bewölkt,6,6,0,
,2021-02-22 23:00:00,19,7,12,Leicht bewölkt,5,5,0,
,2021-02-23 00:00:00,13,10,3,Leicht bewölkt,5,4,0,
,2021-02-23 01:00:00,11,8,3,Leicht bewölkt,4,4,0,
,2021-02-23 02:00:00,3,2,1,Leicht bewölkt,4,3,0,
,2021-02-23 03:00:00,4,4,0,Leicht bewölkt,3,3,0,
,2021-02-23 04:00:00,7,3,4,Leicht bewölkt,3,3,0,
,2021-02-23 05:00:00,52,35,17,Leicht bewölkt,3,3,0,
,2021-02-23 06:00:00,165,99,66,Leicht bewölkt,3,3,0,
,2021-02-23 07:00:00,595,352,243,Leicht bewölkt,4,4,0,
,2021-02-23 08:00:00,743,432,311,Leicht bewölkt,5,5,0,
,2021-02-23 09:00:00,525,315,210,Leicht bewölkt,7,7,0,
,2021-02-23 10:00:00,485,285,200,Leicht bewölkt,8,8,0,
,2021-02-23 11:00:00,507,234,273,Leicht bewölkt,10,10,0,
,2021-02-23 12:00:00,702,319,383,Leicht bewölkt,11,11,0,
,2021-02-23 13:00:00,758,350,408,Leicht bewölkt,12,12,0,
,2021-02-23 14:00:00,743,397,346,Leicht bewölkt,13,13,0,
,2021-02-23 15:00:00,837,446,391,Leicht bewölkt,13,14,0,
,2021-02-23 16:00:00,950,480,470,Leicht bewölkt,13,13,0,
,2021-02-23 17:00:00,951,456,495,Leicht bewölkt,12,13,0,
,2021-02-23 18:00:00,673,277,396,Leicht bewölkt,12,12,0,
,2021-02-23 19:00:00,324,152,172,Leicht bewölkt,11,11,0,
,2021-02-23 20:00:00,147,71,76,Leicht bewölkt,9,9,0,
,2021-02-23 21:00:00,83,47,36,Leicht bewölkt,8,8,0,
,2021-02-23 22:00:00,66,33,33,Leicht bewölkt,8,8,0,
,2021-02-23 23:00:00,54,33,21,Leicht bewölkt,8,8,0,
,2021-02-24 00:00:00,24,10,14,Leicht bewölkt,8,8,0,
,2021-02-24 01:00:00,11,8,3,Leicht bewölkt,7,7,0,
,2021-02-24 02:00:00,6,3,3,Leicht bewölkt,7,7,0,
,2021-02-24 03:00:00,2,1,1,Leicht bewölkt,7,7,0,
,2021-02-24 04:00:00,4,2,2,Leicht bewölkt,6,6,0,
,2021-02-24 05:00:00,55,33,22,Sonnig,6,6,0,
,2021-02-24 06:00:00,168,101,67,Sonnig,6,6,0,
,2021-02-24 07:00:00,544,326,218,Sonnig,7,7,0,
,2021-02-24 08:00:00,704,407,297,Sonnig,8,8,0,
,2021-02-24 09:00:00,509,314,195,Sonnig,10,10,0,
,2021-02-24 10:00:00,444,252,192,Sonnig,12,12,0,
,2021-02-24 11:00:00,478,234,244,Sonnig,13,13,0,
,2021-02-24 12:00:00,696,306,390,Sonnig,15,15,0,
,2021-02-24 13:00:00,729,344,385,Sonnig,16,16,0,
,2021-02-24 14:00:00,744,377,367,Sonnig,17,17,0,
,2021-02-24 15:00:00,845,408,437,Sonnig,17,17,0,
,2021-02-24 16:00:00,988,500,488,Sonnig,17,17,0,
,2021-02-24 17:00:00,874,429,445,Sonnig,16,16,0,
,2021-02-24 18:00:00,658,288,370,Sonnig,16,16,0,
,2021-02-24 19:00:00,344,167,177,Sonnig,14,14,0,
,2021-02-24 20:00:00,157,77,80,Sonnig,13,13,0,
,2021-02-24 21:00:00,87,46,41,Sonnig,12,12,0,
,2021-02-24 22:00:00,75,38,37,Sonnig,11,11,0,
,2021-02-24 23:00:00,62,35,27,Sonnig,10,10,0,
,2021-02-25 00:00:00,22,13,9,Sonnig,9,9,0,
,2021-02-25 01:00:00,10,6,4,Sonnig,8,8,0,
,2021-02-25 02:00:00,7,4,3,Sonnig,7,7,0,
,2021-02-25 03:00:00,2,1,1,Sonnig,6,6,0,
,2021-02-25 04:00:00,10,5,5,Sonnig,6,5,0,
,2021-02-25 05:00:00,49,34,15,Sonnig,5,5,0,
,2021-02-25 06:00:00,166,102,64,Sonnig,5,4,0,
,2021-02-25 07:00:00,553,325,228,Sonnig,6,6,0,
,2021-02-25 08:00:00,706,393,313,Sonnig,8,8,0,
,2021-02-25 09:00:00,479,281,198,Sonnig,9,9,0,
,2021-02-25 10:00:00,395,230,165,Sonnig,11,11,0,
,2021-02-25 11:00:00,514,257,257,Sonnig,13,13,0,
,2021-02-25 12:00:00,715,310,405,Sonnig,15,15,0,
,2021-02-25 13:00:00,732,345,387,Sonnig,16,16,0,
,2021-02-25 14:00:00,761,385,376,Sonnig,17,17,0,
,2021-02-25 15:00:00,892,479,413,Sonnig,17,17,0,
,2021-02-25 16:00:00,985,507,478,Sonnig,17,17,0,
,2021-02-25 17:00:00,964,454,510,Sonnig,16,16,0,
,2021-02-25 18:00:00,694,302,392,Sonnig,16,16,0,
,2021-02-25 19:00:00,341,161,180,Sonnig,15,15,0,
,2021-02-25 20:00:00,166,84,82,Sonnig,14,14,0,
,2021-02-25 21:00:00,98,45,53,Sonnig,13,13,0,
,2021-02-25 22:00:00,82,38,44,Sonnig,12,12,0,
,2021-02-25 23:00:00,45,22,23,Sonnig,10,10,0,
,2021-02-26 00:00:00,23,11,12,Sonnig,9,9,0,
,2021-02-26 01:00:00,16,9,7,Sonnig,8,7,0,
,2021-02-26 02:00:00,9,1,8,Sonnig,7,6,0,
,2021-02-26 03:00:00,4,4,0,Sonnig,6,5,0,
,2021-02-26 04:00:00,6,4,2,Sonnig,5,5,0,
,2021-02-26 05:00:00,40,23,17,Leicht bewölkt,5,4,0,
,2021-02-26 06:00:00,138,85,53,Leicht bewölkt,4,4,0,
,2021-02-26 07:00:00,539,329,210,Leicht bewölkt,5,5,0,
,2021-02-26 08:00:00,639,369,270,Leicht bewölkt,7,7,0,
,2021-02-26 09:00:00,613,376,237,Leicht bewölkt,8,8,0,
,2021-02-26 10:00:00,574,331,243,Leicht bewölkt,10,10,0,
,2021-02-26 11:00:00,629,302,327,Leicht bewölkt,11,12,0,
,2021-02-26 12:00:00,747,325,422,Leicht bewölkt,13,13,0,
,2021-02-26 13:00:00,776,333,443,Leicht bewölkt,13,13,0,
,2021-02-26 14:00:00,778,409,369,Leicht bewölkt,13,14,0,
,2021-02-26 15:00:00,742,373,369,Leicht bewölkt,14,14,0,
,2021-02-26 16:00:00,748,365,383,Leicht bewölkt,13,13,0,
,2021-02-26 17:00:00,730,329,401,Leicht bewölkt,12,12,0,
,2021-02-26 18:00:00,550,262,288,Leicht bewölkt,12,12,0,
,2021-02-26 19:00:00,271,125,146,Leicht bewölkt,11,10,0,
,2021-02-26 20:00:00,168,85,83,Bedeckt,10,9,0,
,2021-02-26 21:00:00,104,52,52,Bedeckt,9,8,0,
,2021-02-26 22:00:00,86,50,36,Bedeckt,8,7,0,
,2021-02-26 23:00:00,56,31,25,Bedeckt,8,6,0.2,
,2021-02-27 00:00:00,65,36,29,Bedeckt,7,5,0.3,
,2021-02-27 01:00:00,40,16,24,Bedeckt,7,4,0.2,
,2021-02-27 02:00:00,19,6,13,Nieselregen,6,3,0.1,
,2021-02-27 03:00:00,15,8,7,Nieselregen,6,3,0.2,
,2021-02-27 04:00:00,4,0,4,Nieselregen,5,2,0.1,
,2021-02-27 05:00:00,22,10,12,Nieselregen,5,1,0.1,
,2021-02-27 06:00:00,33,24,9,Nieselregen,4,0,0.2,
,2021-02-27 07:00:00,56,26,30,Nieselregen,4,1,0.1,
,2021-02-27 08:00:00,160,94,66,Nieselregen,5,1,0,
,2021-02-27 09:00:00,257,148,109,Nieselregen,5,2,0,
,2021-02-27 10:00:00,399,207,192,Nieselregen,6,3,0,
,2021-02-27 11:00:00,512,256,256,Leicht bewölkt,7,4,0,
,2021-02-27 12:00:00,519,236,283,Leicht bewölkt,8,5,0,
,2021-02-27 13:00:00,552,264,288,Leicht bewölkt,8,5,0,
,2021-02-27 14:00:00,845,236,609,Sonnig,8,6,0,
,2021-02-27 15:00:00,631,310,321,Sonnig,9,6,0,
,2021-02-27 16:00:00,460,253,207,Sonnig,8,4,0,
,2021-02-27 17:00:00,548,288,260,Sonnig,7,3,0,
,2021-02-27 18:00:00,368,195,173,Sonnig,5,2,0,
,2021-02-27 19:00:00,223,106,117,Sonnig,5,1,0,
,2021-02-27 20:00:00,127,72,55,Sonnig,4,0,0,
,2021-02-27 21:00:00,98,53,45,Sonnig,3,-1,0,
,2021-02-27 22:00:00,54,31,23,Sonnig,3,-2,0,
,2021-02-27 23:00:00,73,31,42,Sonnig,2,-2,0,
,2021-02-28 00:00:00,57,27,30,Sonnig,2,-3,0,
,2021-02-28 01:00:00,36,12,24,Sonnig,1,-3,0,
,2021-02-28 02:00:00,15,9,6,Leicht bewölkt,1,-4,0,
,2021-02-28 03:00:00,24,10,14,Leicht bewölkt,1,-4,0,
,2021-02-28 04:00:00,5,2,3,Leicht bewölkt,0,-4,0,
,2021-02-28 05:00:00,12,5,7,Leicht bewölkt,0,-4,0,
,2021-02-28 06:00:00,21,14,7,Leicht bewölkt,0,-4,0,
,2021-02-28 07:00:00,33,21,12,Leicht bewölkt,1,-3,0,
,2021-02-28 08:00:00,73,36,37,Leicht bewölkt,2,-1,0,
,2021-02-28 09:00:00,156,84,72,Leicht bewölkt,4,1,0,
,2021-02-28 10:00:00,218,103,115,Leicht bewölkt,5,3,0,
,2021-02-28 11:00:00,270,118,152,Sonnig,6,4,0,
,2021-02-28 12:00:00,404,179,225,Sonnig,8,6,0,
,2021-02-28 13:00:00,473,208,265,Sonnig,8,7,0,
,2021-02-28 14:00:00,648,349,299,Sonnig,9,7,0,
,2021-02-28 15:00:00,619,325,294,Sonnig,10,8,0,
,2021-02-28 16:00:00,599,343,256,Sonnig,9,8,0,
,2021-02-28 17:00:00,593,309,284,Sonnig,9,8,0,
,2021-02-28 18:00:00,367,214,153,Sonnig,9,8,0,
,2021-02-28 19:00:00,167,84,83,Sonnig,8,7,0,
,2021-02-28 20:00:00,102,47,55,Sonnig,7,7,0,
,2021-02-28 21:00:00,76,40,36,Sonnig,6,6,0,
,2021-02-28 22:00:00,54,23,31,Sonnig,4,4,0,
,2021-02-28 23:00:00,24,11,13,Leicht bewölkt,2,1,0,
,2021-03-01 00:00:00,14,12,2,Leicht bewölkt,1,-1,0,
,2021-03-01 01:00:00,3,0,3,Leicht bewölkt,1,-1,0,
,2021-03-01 02:00:00,0,0,0,Leicht bewölkt,1,-1,0,
,2021-03-01 03:00:00,1,1,0,Leicht bewölkt,1,-1,0,
,2021-03-01 04:00:00,9,4,5,Leicht bewölkt,0,-1,0,
,2021-03-01 05:00:00,29,17,12,Sonnig,0,-2,0,
,2021-03-01 06:00:00,166,102,64,Sonnig,-1,-2,0,
,2021-03-01 07:00:00,574,363,211,Sonnig,1,0,0,
,2021-03-01 08:00:00,708,384,324,Leicht bewölkt,3,2,0,
,2021-03-01 09:00:00,503,277,226,Leicht bewölkt,5,4,0,
,2021-03-01 10:00:00,431,233,198,Leicht bewölkt,7,6,0,
,2021-03-01 11:00:00,537,280,257,Sonnig,9,9,0,
,2021-03-01 12:00:00,622,280,342,Sonnig,11,11,0,
,2021-03-01 13:00:00,793,402,391,Sonnig,11,12,0,
,2021-03-01 14:00:00,693,376,317,Sonnig,12,13,0,
,2021-03-01 15:00:00,813,404,409,Sonnig,13,14,0,
,2021-03-01 16:00:00,860,431,429,Sonnig,12,13,0,
,2021-03-01 17:00:00,918,413,505,Sonnig,11,12,0,
,2021-03-01 18:00:00,649,284,365,Sonnig,11,11,0,
,2021-03-01 19:00:00,322,140,182,Sonnig,9,9,0,
,2021-03-01 20:00:00,156,83,73,Sonnig,8,8,0,
,2021-03-01 21:00:00,74,42,32,Sonnig,7,7,0,
,2021-03-01 22:00:00,51,23,28,Sonnig,6,6,0,
,2021-03-01 23:00:00,33,20,13,Sonnig,5,5,0,
,2021-03-02 00:00:00,7,3,4,Sonnig,5,5,0,
,2021-03-02 01:00:00,13,5,8,Sonnig,4,4,0,
,2021-03-02 02:00:00,4,0,4,Sonnig,3,3,0,
,2021-03-02 03:00:00,5,2,3,Sonnig,2,2,0,
,2021-03-02 04:00:00,6,3,3,Sonnig,2,2,0,
,2021-03-02 05:00:00,44,25,19,Sonnig,2,2,0,
,2021-03-02 06:00:00,186,110,76,Sonnig,1,1,0,
,2021-03-02 07:00:00,622,363,259,Sonnig,3,3,0,
,2021-03-02 08:00:00,753,416,337,Sonnig,4,4,0,
,2021-03-02 09:00:00,556,328,228,Sonnig,6,6,0,
,2021-03-02 10:00:00,487,290,197,Sonnig,8,8,0,
,2021-03-02 11:00:00,545,282,263,Sonnig,10,10,0,
,2021-03-02 12:00:00,711,314,397,Sonnig,12,12,0,
,2021-03-02 13:00:00,732,336,396,Sonnig,13,13,0,
,2021-03-02 14:00:00,738,386,352,Sonnig,14,14,0,
,2021-03-02 15:00:00,814,388,426,Sonnig,14,14,0,
,2021-03-02 16:00:00,890,447,443,Sonnig,14,14,0,
,2021-03-02 17:00:00,997,479,518,Sonnig,13,13,0,
,2021-03-02 18:00:00,690,283,407,Sonnig,13,13,0,
,2021-03-02 19:00:00,334,153,181,Sonnig,12,12,0,
,2021-03-02 20:00:00,175,80,95,Sonnig,11,11,0,
,2021-03-02 21:00:00,72,29,43,Sonnig,10,10,0,
,2021-03-02 22:00:00,55,23,32,Sonnig,8,8,0,
,2021-03-02 23:00:00,38,23,15,Leicht bewölkt,6,6,0,
,2021-03-03 00:00:00,15,7,8,Leicht bewölkt,3,3,0,
,2021-03-03 01:00:00,5,3,2,Leicht bewölkt,3,3,0,
,2021-03-03 02:00:00,4,4,0,Leicht bewölkt,2,2,0,
,2021-03-03 03:00:00,5,3,2,Leicht bewölkt,1,1,0,
,2021-03-03 04:00:00,4,3,1,Leicht bewölkt,1,1,0,
,2021-03-03 05:00:00,49,27,22,Leicht bewölkt,1,1,0,
,2021-03-03 06:00:00,163,99,64,Leicht bewölkt,1,1,0,
,2021-03-03 07:00:00,535,315,220,Leicht bewölkt,3,3,0,
,2021-03-03 08:00:00,762,420,342,Leicht bewölkt,4,4,0,
,2021-03-03 09:00:00,538,328,210,Leicht bewölkt,6,6,0,
,2021-03-03 10:00:00,439,225,214,Leicht bewölkt,8,8,0,
,2021-03-03 11:00:00,498,263,235,Leicht bewölkt,10,10,0,
,2021-03-03 12:00:00,602,280,322,Leicht bewölkt,12,12,0,
,2021-03-03 13:00:00,697,316,381,Leicht bewölkt,13,13,0,
,2021-03-03 14:00:00,668,348,320,Leicht bewölkt,13,14,0,
,2021-03-03 15:00:00,676,325,351,Leicht bewölkt,14,14,0,
,2021-03-03 16:00:00,788,376,412,Leicht bewölkt,13,13,0,
,2021-03-03 17:00:00,794,385,409,Leicht bewölkt,12,12,0,
,2021-03-03 18:00:00,566,246,320,Leicht bewölkt,11,11,0,
,2021-03-03 19:00:00,332,161,171,Leicht bewölkt,10,10,0,
,2021-03-03 20:00:00,161,79,82,Leicht bewölkt,8,8,0,
,2021-03-03 21:00:00,107,61,46,Leicht bewölkt,7,7,0,
,2021-03-03 22:00:00,63,36,27,Leicht bewölkt,6,6,0,
,2021-03-03 23:00:00,23,11,12,Leicht bewölkt,5,4,0,
,2021-03-04 00:00:00,23,8,15,Leicht bewölkt,4,3,0,
,2021-03-04 01:00:00,5,1,4,Leicht bewölkt,4,3,0,
,2021-03-04 02:00:00,8,5,3,Leicht bewölkt,3,3,0,
,2021-03-04 03:00:00,3,2,1,Leicht bewölkt,3,2,0,
,2021-03-04 04:00:00,9,6,3,Leicht bewölkt,3,2,0,
,2021-03-04 05:00:00,42,23,19,Leicht bewölkt,3,2,0,
,2021-03-04 06:00:00,159,99,60,Leicht bewölkt,2,2,0,
,2021-03-04 07:00:00,571,341,230,Leicht bewölkt,4,3,0,
,2021-03-04 08:00:00,706,383,323,Leicht bewölkt,5,5,0,
,2021-03-04 09:00:00,493,286,207,Leicht bewölkt,7,6,0,
,2021-03-04 10:00:00,422,231,191,Leicht bewölkt,8,8,0,
,2021-03-04 11:00:00,520,270,250,Leicht bewölkt,10,9,0,
,2021-03-04 12:00:00,605,265,340,Leicht bewölkt,11,10,0,
,2021-03-04 13:00:00,667,324,343,Leicht bewölkt,11,10,0,
,2021-03-04 14:00:00,652,328,324,Leicht bewölkt,11,10,0,
,2021-03-04 15:00:00,715,364,351,Leicht bewölkt,12,10,0,
,2021-03-04 16:00:00,787,403,384,Leicht bewölkt,10,9,0,
,2021-03-04 17:00:00,730,336,394,Stellenweiser Regenfall,9,8,0.3,
,2021-03-04 18:00:00,612,264,348,Stellenweiser Regenfall,8,6,0.4,
,2021-03-04 19:00:00,304,127,177,Stellenweiser Regenfall,8,6,0.2,
,2021-03-04 20:00:00,156,74,82,Leichter Regenfall,7,5,0.7,
,2021-03-04 21:00:00,73,39,34,Leichter Regenfall,6,4,0.9,
,2021-03-04 22:00:00,71,42,29,Leichter Regenfall,6,5,0.5,
,2021-03-04 23:00:00,37,17,20,Mäßiger Regenfall,6,5,1.1,
,2021-03-05 00:00:00,19,14,5,Mäßiger Regenfall,7,5,2.1,
,2021-03-05 01:00:00,8,6,2,Mäßiger Regenfall,6,5,1.1,
,2021-03-05 02:00:00,10,5,5,Mäßiger bis starker Regen mit Gewitter,6,5,0.5,
,2021-03-05 03:00:00,1,1,0,Mäßiger bis starker Regen mit Gewitter,6,5,0.7,
,2021-03-05 04:00:00,11,8,3,Mäßiger bis starker Regen mit Gewitter,6,4,0.4,
,2021-03-05 05:00:00,39,18,21,Mäßiger bis starker Regen mit Gewitter,6,4,0.6,
,2021-03-05 06:00:00,130,85,45,Mäßiger bis starker Regen mit Gewitter,6,4,0.8,
,2021-03-05 07:00:00,500,293,207,Mäßiger bis starker Regen mit Gewitter,6,5,0.4,
,2021-03-05 08:00:00,624,341,283,Leichter Regenfall,6,5,0.5,
,2021-03-05 09:00:00,458,274,184,Leichter Regenfall,6,5,0.7,
,2021-03-05 10:00:00,423,248,175,Leichter Regenfall,6,4,0.4,
,2021-03-05 11:00:00,459,219,240,Leichter Regenfall,5,3,0.7,
,2021-03-05 12:00:00,533,251,282,Leichter Regenfall,5,3,1,
,2021-03-05 13:00:00,602,251,351,Leichter Regenfall,4,2,0.5,
,2021-03-05 14:00:00,566,311,255,Mäßiger Regenfall,4,1,0.7,
,2021-03-05 15:00:00,495,252,243,Mäßiger Regenfall,3,0,0.9,
,2021-03-05 16:00:00,542,271,271,Mäßiger Regenfall,3,-1,0.5,
,2021-03-05 17:00:00,449,196,253,Starker Schneefall,2,-1,0.8,
,2021-03-05 18:00:00,420,194,226,Starker Schneefall,2,-2,1,
,2021-03-05 19:00:00,290,148,142,Starker Schneefall,1,-3,0.5,
,2021-03-05 20:00:00,151,77,74,Starker Schneefall,1,-3,0.3,
,2021-03-05 21:00:00,63,37,26,Starker Schneefall,1,-4,0.4,
,2021-03-05 22:00:00,55,32,23,Starker Schneefall,0,-4,0.2,
,2021-03-05 23:00:00,45,22,23,Stellenweise leichter Schneefall,0,-4,0,
,2021-03-06 00:00:00,49,25,24,Stellenweise leichter Schneefall,0,-5,0.1,
,2021-03-06 01:00:00,26,12,14,Stellenweise leichter Schneefall,0,-5,0,
,2021-03-06 02:00:00,17,7,10,Stellenweise leichter Schneefall,0,-5,0,
,2021-03-06 03:00:00,22,9,13,Stellenweise leichter Schneefall,-1,-5,0,
,2021-03-06 04:00:00,10,4,6,Stellenweise leichter Schneefall,-1,-5,0,
,2021-03-06 05:00:00,26,8,18,Leicht bewölkt,-1,-6,0,
,2021-03-06 06:00:00,34,25,9,Leicht bewölkt,-1,-6,0,
,2021-03-06 07:00:00,57,28,29,Leicht bewölkt,0,-5,0,
,2021-03-06 08:00:00,184,100,84,Leicht bewölkt,0,-4,0,
,2021-03-06 09:00:00,294,173,121,Leicht bewölkt,1,-3,0,
,2021-03-06 10:00:00,408,209,199,Leicht bewölkt,2,-1,0,
,2021-03-06 11:00:00,442,215,227,Leicht bewölkt,4,1,0,
,2021-03-06 12:00:00,461,262,199,Leicht bewölkt,5,2,0,
,2021-03-06 13:00:00,554,283,271,Leicht bewölkt,6,3,0,
,2021-03-06 14:00:00,1440,264,1176,Sonnig,6,4,0,
,2021-03-06 15:00:00,633,267,366,Sonnig,7,4,0,
,2021-03-06 16:00:00,561,295,266,Sonnig,6,5,0,
,2021-03-06 17:00:00,571,305,266,Sonnig,6,5,0,
,2021-03-06 18:00:00,425,218,207,Sonnig,6,5,0,
,2021-03-06 19:00:00,241,110,131,Sonnig,5,4,0,
,2021-03-06 20:00:00,171,101,70,Leicht bewölkt,4,4,0,
,2021-03-06 21:00:00,96,53,43,Leicht bewölkt,4,4,0,
,2021-03-06 22:00:00,62,27,35,Leicht bewölkt,2,2,0,
,2021-03-06 23:00:00,58,26,32,Leicht bewölkt,1,1,0,
,2021-03-07 00:00:00,55,27,28,Leicht bewölkt,0,-1,0,
,2021-03-07 01:00:00,48,29,19,Leicht bewölkt,-1,-1,0,
,2021-03-07 02:00:00,21,7,14,Leicht bewölkt,-1,-1,0,
,2021-03-07 03:00:00,19,10,9,Leicht bewölkt,-1,-1,0,
,2021-03-07 04:00:00,12,7,5,Leicht bewölkt,-2,-2,0,
,2021-03-07 05:00:00,20,7,13,Leicht bewölkt,-2,-2,0,
,2021-03-07 06:00:00,25,18,7,Leicht bewölkt,-2,-2,0,
,2021-03-07 07:00:00,30,14,16,Leicht bewölkt,0,0,0,
,2021-03-07 08:00:00,50,26,24,Leicht bewölkt,1,1,0,
,2021-03-07 09:00:00,150,78,72,Leicht bewölkt,3,3,0,
,2021-03-07 10:00:00,172,84,88,Leicht bewölkt,5,5,0,
,2021-03-07 11:00:00,268,135,133,Leicht bewölkt,7,6,0,
,2021-03-07 12:00:00,324,173,151,Leicht bewölkt,8,8,0,
,2021-03-07 13:00:00,380,175,205,Leicht bewölkt,9,8,0,
,2021-03-07 14:00:00,442,250,192,Leicht bewölkt,9,9,0,
,2021-03-07 15:00:00,475,258,217,Leicht bewölkt,10,9,0,
,2021-03-07 16:00:00,405,196,209,Leicht bewölkt,9,9,0,
,2021-03-07 17:00:00,386,201,185,Stellenweiser Regenfall,9,8,0.1,
,2021-03-07 18:00:00,269,144,125,Stellenweiser Regenfall,8,8,0.1,
,2021-03-07 19:00:00,194,107,87,Stellenweiser Regenfall,7,7,0,
,2021-03-07 20:00:00,87,43,44,Leichter Regenschauer,6,6,0.1,
,2021-03-07 21:00:00,60,24,36,Leichter Regenschauer,5,5,0.2,
,2021-03-07 22:00:00,51,29,22,Leichter Regenschauer,4,4,0.1,
,2021-03-07 23:00:00,28,7,21,Stellenweiser Regenfall,3,3,0.1,
,2021-03-08 00:00:00,10,7,3,Stellenweiser Regenfall,3,2,0.1,
,2021-03-08 01:00:00,6,4,2,Stellenweiser Regenfall,2,1,0.1,
,2021-03-08 02:00:00,5,3,2,Stellenweiser Nieselregen,2,1,0,
,2021-03-08 03:00:00,1,1,0,Stellenweiser Nieselregen,2,0,0,
,2021-03-08 04:00:00,6,3,3,Stellenweiser Nieselregen,1,0,0,
,2021-03-08 05:00:00,34,20,14,Leicht bewölkt,1,-1,0,
,2021-03-08 06:00:00,163,108,55,Leicht bewölkt,1,-1,0,
,2021-03-08 07:00:00,602,358,244,Leicht bewölkt,2,0,0,
,2021-03-08 08:00:00,680,390,290,Mäßiger Schneefall,2,1,0,
,2021-03-08 09:00:00,560,339,221,Mäßiger Schneefall,3,2,0,
,2021-03-08 10:00:00,423,232,191,Mäßiger Schneefall,5,3,0,
,2021-03-08 11:00:00,467,229,238,Stellenweiser Regenfall,6,5,0,
,2021-03-08 12:00:00,634,293,341,Stellenweiser Regenfall,7,6,0,
,2021-03-08 13:00:00,823,381,442,Stellenweiser Regenfall,7,6,0,
,2021-03-08 14:00:00,611,350,261,Stellenweiser Regenfall,8,6,0,
,2021-03-08 15:00:00,771,400,371,Stellenweiser Regenfall,8,7,0,
,2021-03-08 16:00:00,855,415,440,Stellenweiser Regenfall,7,6,0,
,2021-03-08 17:00:00,922,403,519,Leicht bewölkt,6,5,0,
,2021-03-08 18:00:00,669,303,366,Leicht bewölkt,5,5,0,
,2021-03-08 19:00:00,349,163,186,Leicht bewölkt,4,3,0,
,2021-03-08 20:00:00,176,69,107,Leicht bewölkt,3,1,0,
,2021-03-08 21:00:00,95,41,54,Leicht bewölkt,1,-1,0,
,2021-03-08 22:00:00,72,35,37,Leicht bewölkt,1,-1,0,
,2021-03-08 23:00:00,25,14,11,Leicht bewölkt,0,-1,0,
,2021-03-09 00:00:00,20,12,8,Leicht bewölkt,0,-1,0,
,2021-03-09 01:00:00,12,12,0,Leicht bewölkt,0,-1,0,
,2021-03-09 02:00:00,8,3,5,Leicht bewölkt,-1,-2,0,
,2021-03-09 03:00:00,1,0,1,Leicht bewölkt,-2,-2,0,
,2021-03-09 04:00:00,3,2,1,Leicht bewölkt,-2,-2,0,
,2021-03-09 05:00:00,38,20,18,Leicht bewölkt,-2,-2,0,
,2021-03-09 06:00:00,186,114,72,Leicht bewölkt,-2,-2,0,
,2021-03-09 07:00:00,635,374,261,Leicht bewölkt,0,0,0,
,2021-03-09 08:00:00,733,402,331,Leicht bewölkt,1,1,0,
,2021-03-09 09:00:00,583,342,241,Leicht bewölkt,2,2,0,
,2021-03-09 10:00:00,496,283,213,Leicht bewölkt,4,4,0,
,2021-03-09 11:00:00,523,272,251,Bedeckt,5,5,0,
,2021-03-09 12:00:00,708,300,408,Bedeckt,6,6,0,
,2021-03-09 13:00:00,647,312,335,Bedeckt,7,7,0,
,2021-03-09 14:00:00,735,390,345,Bedeckt,8,8,0,
,2021-03-09 15:00:00,758,378,380,Bedeckt,8,8,0,
,2021-03-09 16:00:00,967,474,493,Bedeckt,8,8,0,
,2021-03-09 17:00:00,889,400,489,Leicht bewölkt,7,7,0,
,2021-03-09 18:00:00,641,267,374,Leicht bewölkt,7,7,0,
,2021-03-09 19:00:00,352,163,189,Leicht bewölkt,6,6,0,
,2021-03-09 20:00:00,167,88,79,Leicht bewölkt,5,5,0,
,2021-03-09 21:00:00,107,50,57,Leicht bewölkt,4,4,0,
,2021-03-09 22:00:00,66,32,34,Leicht bewölkt,3,3,0,
,2021-03-09 23:00:00,39,24,15,Leicht bewölkt,2,2,0,
,2021-03-10 00:00:00,20,11,9,Leicht bewölkt,1,1,0,
,2021-03-10 01:00:00,12,4,8,Leicht bewölkt,1,1,0,
,2021-03-10 02:00:00,5,2,3,Bewölkt,0,0,0,
,2021-03-10 03:00:00,3,2,1,Bewölkt,0,0,0,
,2021-03-10 04:00:00,7,4,3,Bewölkt,0,-1,0,
,2021-03-10 05:00:00,44,25,19,Bewölkt,0,-1,0,
,2021-03-10 06:00:00,165,107,58,Bewölkt,0,-1,0,
,2021-03-10 07:00:00,554,329,225,Bewölkt,1,0,0,
,2021-03-10 08:00:00,726,421,305,Bewölkt,2,1,0,
,2021-03-10 09:00:00,543,324,219,Bewölkt,3,2,0,
,2021-03-10 10:00:00,489,272,217,Bewölkt,4,3,0,
,2021-03-10 11:00:00,541,290,251,Leicht bewölkt,6,5,0,
,2021-03-10 12:00:00,696,306,390,Leicht bewölkt,7,6,0,
,2021-03-10 13:00:00,752,355,397,Leicht bewölkt,7,7,0,
,2021-03-10 14:00:00,694,364,330,Leicht bewölkt,8,8,0,
,2021-03-10 15:00:00,793,398,395,Leicht bewölkt,9,9,0,
,2021-03-10 16:00:00,939,443,496,Leicht bewölkt,8,8,0,
,2021-03-10 17:00:00,954,454,500,Leicht bewölkt,7,7,0,
,2021-03-10 18:00:00,673,320,353,Leicht bewölkt,6,6,0,
,2021-03-10 19:00:00,369,169,200,Leicht bewölkt,5,4,0,
,2021-03-10 20:00:00,196,82,114,Leicht bewölkt,3,3,0,
,2021-03-10 21:00:00,111,46,65,Leicht bewölkt,2,1,0,
,2021-03-10 22:00:00,65,26,39,Leicht bewölkt,2,1,0,
,2021-03-10 23:00:00,38,16,22,Bedeckt,3,1,0,
,2021-03-11 00:00:00,25,18,7,Bedeckt,3,1,0,
,2021-03-11 01:00:00,12,10,2,Bedeckt,4,2,0,
,2021-03-11 02:00:00,8,5,3,Bedeckt,4,2,0,
,2021-03-11 03:00:00,7,4,3,Bedeckt,4,2,0,
,2021-03-11 04:00:00,8,5,3,Bedeckt,4,2,0,
,2021-03-11 05:00:00,38,23,15,Bewölkt,5,3,0,
,2021-03-11 06:00:00,155,95,60,Bewölkt,5,3,0,
,2021-03-11 07:00:00,520,299,221,Bewölkt,5,3,0,
,2021-03-11 08:00:00,704,388,316,Bewölkt,5,3,0,
,2021-03-11 09:00:00,547,334,213,Bewölkt,5,3,0,
,2021-03-11 10:00:00,460,242,218,Bewölkt,7,5,0,
,2021-03-11 11:00:00,487,248,239,Stellenweiser Nieselregen,9,7,0,
,2021-03-11 12:00:00,585,250,335,Stellenweiser Nieselregen,11,8,0,
,2021-03-11 13:00:00,582,280,302,Stellenweiser Nieselregen,11,9,0,
,2021-03-11 14:00:00,503,245,258,Bedeckt,12,10,0,
,2021-03-11 15:00:00,525,240,285,Bedeckt,13,11,0,
,2021-03-11 16:00:00,584,287,297,Bedeckt,12,10,0,
,2021-03-11 17:00:00,545,266,279,Leichter Regenschauer,11,9,0,
,2021-03-11 18:00:00,456,192,264,Leichter Regenschauer,11,8,0,
,2021-03-11 19:00:00,213,97,116,Leichter Regenschauer,10,7,0,
,2021-03-11 20:00:00,132,61,71,Bedeckt,9,6,1.4,
,2021-03-11 21:00:00,69,36,33,Bedeckt,8,5,1.9,
,2021-03-11 22:00:00,51,25,26,Bedeckt,7,4,0.9,
,2021-03-11 23:00:00,33,12,21,Starker Regenfall,7,3,2.8,
,2021-03-12 00:00:00,15,10,5,Starker Regenfall,6,2,5.7,
,2021-03-12 01:00:00,13,11,2,Starker Regenfall,6,2,2.8,
,2021-03-12 02:00:00,10,6,4,Starker Regenfall,6,1,1,
,2021-03-12 03:00:00,2,1,1,Starker Regenfall,5,1,1.4,
,2021-03-12 04:00:00,10,7,3,Starker Regenfall,5,1,0.7,
,2021-03-12 05:00:00,30,17,13,Stellenweiser Regenfall,4,1,0,
,2021-03-12 06:00:00,142,86,56,Stellenweiser Regenfall,4,1,0,
,2021-03-12 07:00:00,518,323,195,Stellenweiser Regenfall,4,1,0,
,2021-03-12 08:00:00,689,400,289,Leicht bewölkt,5,2,0.1,
,2021-03-12 09:00:00,597,336,261,Leicht bewölkt,5,2,0.1,
,2021-03-12 10:00:00,550,314,236,Leicht bewölkt,6,3,0,
,2021-03-12 11:00:00,630,315,315,Leichter Regenschauer,7,4,0.1,
,2021-03-12 12:00:00,747,339,408,Leichter Regenschauer,7,4,0.1,
,2021-03-12 13:00:00,721,305,416,Leichter Regenschauer,8,5,0.1,
,2021-03-12 14:00:00,748,395,353,Leichter Regenschauer,8,5,0.1,
,2021-03-12 15:00:00,743,378,365,Leichter Regenschauer,8,5,0.1,
,2021-03-12 16:00:00,745,361,384,Leichter Regenschauer,7,5,0.1,
,2021-03-12 17:00:00,726,364,362,Leichter Regenschauer,7,5,0.1,
,2021-03-12 18:00:00,594,266,328,Leichter Regenschauer,6,5,0.1,
,2021-03-12 19:00:00,369,186,183,Leichter Regenschauer,5,4,0,
,2021-03-12 20:00:00,237,118,119,Stellenweiser Regenfall,4,3,0,
,2021-03-12 21:00:00,99,42,57,Stellenweiser Regenfall,3,1,0,
,2021-03-12 22:00:00,75,36,39,Stellenweiser Regenfall,3,1,0,
,2021-03-12 23:00:00,80,31,49,Bedeckt,4,1,0,
,2021-03-13 00:00:00,69,26,43,Bedeckt,4,0,0,
,2021-03-13 01:00:00,49,30,19,Bedeckt,4,0,0,
,2021-03-13 02:00:00,23,10,13,Leicht bewölkt,3,0,0,
,2021-03-13 03:00:00,15,3,12,Leicht bewölkt,3,0,0,
,2021-03-13 04:00:00,7,5,2,Leicht bewölkt,3,-1,0,
,2021-03-13 05:00:00,27,16,11,Leicht bewölkt,3,-1,0,
,2021-03-13 06:00:00,46,26,20,Leicht bewölkt,2,-1,0,
,2021-03-13 07:00:00,65,30,35,Leicht bewölkt,3,0,0,
,2021-03-13 08:00:00,174,103,71,Leicht bewölkt,4,1,0,
,2021-03-13 09:00:00,329,189,140,Leicht bewölkt,6,2,0,
,2021-03-13 10:00:00,473,250,223,Leicht bewölkt,7,4,0,
,2021-03-13 11:00:00,432,213,219,Leicht bewölkt,9,5,0,
,2021-03-13 12:00:00,473,225,248,Leicht bewölkt,10,7,0,
,2021-03-13 13:00:00,442,219,223,Leicht bewölkt,10,7,0,
,2021-03-13 14:00:00,1040,176,864,Leicht bewölkt,11,8,0,
,2021-03-13 15:00:00,380,181,199,Leicht bewölkt,11,9,0,
,2021-03-13 16:00:00,265,129,136,Leicht bewölkt,10,8,0,
,2021-03-13 17:00:00,289,130,159,Bedeckt,10,7,0,
,2021-03-13 18:00:00,294,135,159,Bedeckt,9,7,0,
,2021-03-13 19:00:00,155,85,70,Bedeckt,8,5,0,
,2021-03-13 20:00:00,91,50,41,Bedeckt,6,3,0.8,
,2021-03-13 21:00:00,64,32,32,Bedeckt,5,2,1,
,2021-03-13 22:00:00,41,27,14,Bedeckt,5,1,0.5,
,2021-03-13 23:00:00,42,20,22,Mäßiger Regenfall,4,0,1.8,
,2021-03-14 00:00:00,45,23,22,Mäßiger Regenfall,4,0,3.7,
,2021-03-14 01:00:00,31,11,20,Mäßiger Regenfall,3,-1,1.8,
,2021-03-14 02:00:00,10,4,6,Mäßiger Regenfall,3,-1,1.2,
,2021-03-14 03:00:00,16,9,7,Mäßiger Regenfall,3,-2,1.6,
,2021-03-14 04:00:00,3,1,2,Mäßiger Regenfall,2,-2,0.8,
,2021-03-14 05:00:00,5,4,1,Starker Schneefall,2,-3,0.8,
,2021-03-14 06:00:00,23,12,11,Starker Schneefall,2,-3,1.1,
,2021-03-14 07:00:00,29,5,24,Starker Schneefall,2,-3,0.5,
,2021-03-14 08:00:00,47,25,22,Mäßiger bis starker Schneefall mit Gewitter,2,-3,0.6,
,2021-03-14 09:00:00,133,73,60,Mäßiger bis starker Schneefall mit Gewitter,3,-3,0.8,
,2021-03-14 10:00:00,151,73,78,Mäßiger bis starker Schneefall mit Gewitter,3,-2,0.4,
,2021-03-14 11:00:00,246,114,132,Mäßiger bis starker Schneefall mit Gewitter,4,-1,0.8,
,2021-03-14 12:00:00,284,150,134,Mäßiger bis starker Schneefall mit Gewitter,4,0,1.1,
,2021-03-14 13:00:00,271,151,120,Mäßiger bis starker Schneefall mit Gewitter,4,0,0.6,
,2021-03-14 14:00:00,297,188,109,Mäßige bis starke Eisregen,5,0,0.6,
,2021-03-14 15:00:00,193,107,86,Mäßige bis starke Eisregen,5,0,0.8,
,2021-03-14 16:00:00,185,82,103,Mäßige bis starke Eisregen,4,0,0.4,
,2021-03-14 17:00:00,211,103,108,Leichte Eisregen,4,-1,0.5,
,2021-03-14 18:00:00,195,100,95,Leichte Eisregen,3,-1,0.7,
,2021-03-14 19:00:00,133,62,71,Leichte Eisregen,3,-1,0.4,
,2021-03-14 20:00:00,106,37,69,Mäßige bis starke Schneefälle,2,-2,0.2,
,2021-03-14 21:00:00,59,31,28,Mäßige bis starke Schneefälle,2,-2,0.3,
,2021-03-14 22:00:00,37,23,14,Mäßige bis starke Schneefälle,2,-2,0.1,
,2021-03-14 23:00:00,18,7,11,Mäßige bis starke Schneefälle,2,-1,0.2,
,2021-03-15 00:00:00,21,9,12,Mäßige bis starke Schneefälle,3,-1,0.4,
,2021-03-15 01:00:00,10,6,4,Mäßige bis starke Schneefälle,3,-1,0.2,
,2021-03-15 02:00:00,1,0,1,Mäßige bis starke Schneefälle,3,-1,0.3,
,2021-03-15 03:00:00,3,2,1,Mäßige bis starke Schneefälle,3,-2,0.4,
,2021-03-15 04:00:00,6,5,1,Mäßige bis starke Schneefälle,2,-2,0.2,
,2021-03-15 05:00:00,37,22,15,Mäßige bis starke Schneefälle,2,-2,0.4,
,2021-03-15 06:00:00,125,85,40,Mäßige bis starke Schneefälle,2,-2,0.5,
,2021-03-15 07:00:00,600,393,207,Mäßige bis starke Schneefälle,2,-3,0.2,
,2021-03-15 08:00:00,526,285,241,Starker Schneefall,2,-3,0.6,
,2021-03-15 09:00:00,386,233,153,Starker Schneefall,2,-3,0.8,
,2021-03-15 10:00:00,264,145,119,Starker Schneefall,2,-3,0.4,
,2021-03-15 11:00:00,344,160,184,Starker Schneefall,3,-2,0.7,
,2021-03-15 12:00:00,399,175,224,Starker Schneefall,3,-2,1,
,2021-03-15 13:00:00,653,302,351,Starker Schneefall,3,-2,0.5,
,2021-03-15 14:00:00,455,251,204,Starker Schneefall,3,-2,0.4,
,2021-03-15 15:00:00,521,240,281,Starker Schneefall,3,-2,0.6,
,2021-03-15 16:00:00,465,209,256,Starker Schneefall,3,-2,0.3,
,2021-03-15 17:00:00,580,269,311,Leichter Eisregen,2,-2,0.4,
,2021-03-15 18:00:00,428,205,223,Leichter Eisregen,2,-1,0.5,
,2021-03-15 19:00:00,247,115,132,Leichter Eisregen,1,-2,0.2,
,2021-03-15 20:00:00,147,64,83,Leichter Eisregen,0,-2,0.4,
,2021-03-15 21:00:00,77,41,36,Leichter Eisregen,-1,-2,0.5,
,2021-03-15 22:00:00,58,29,29,Leichter Eisregen,0,-2,0.2,
,2021-03-15 23:00:00,32,14,18,Leichte Eisregen,1,-2,0.4,
,2021-03-16 00:00:00,12,4,8,Leichte Eisregen,2,-1,0.9,
,2021-03-16 01:00:00,10,7,3,Leichte Eisregen,2,-2,0.4,
,2021-03-16 02:00:00,2,1,1,Mäßige bis starke Schneefälle,2,-2,0.8,
,2021-03-16 03:00:00,5,2,3,Mäßige bis starke Schneefälle,2,-2,1.1,
,2021-03-16 04:00:00,4,2,2,Mäßige bis starke Schneefälle,1,-2,0.6,
,2021-03-16 05:00:00,36,24,12,Starker Schneefall,1,-3,0.9,
,2021-03-16 06:00:00,165,105,60,Starker Schneefall,1,-3,1.2,
,2021-03-16 07:00:00,719,448,271,Starker Schneefall,1,-3,0.6,
,2021-03-16 08:00:00,649,380,269,Stellenweise starker Schneefall,1,-3,0.4,
,2021-03-16 09:00:00,508,290,218,Stellenweise starker Schneefall,1,-3,0.5,
,2021-03-16 10:00:00,389,219,170,Stellenweise starker Schneefall,2,-2,0.2,
,2021-03-16 11:00:00,439,221,218,Mäßige bis starke Schneefälle,3,-1,0.3,
,2021-03-16 12:00:00,517,198,319,Mäßige bis starke Schneefälle,4,0,0.4,
,2021-03-16 13:00:00,637,277,360,Mäßige bis starke Schneefälle,4,0,0.2,
,2021-03-16 14:00:00,470,261,209,Leichte Eisregen,4,0,0.5,
,2021-03-16 15:00:00,526,265,261,Leichte Eisregen,5,1,0.6,
,2021-03-16 16:00:00,665,315,350,Leichte Eisregen,4,0,0.3,
,2021-03-16 17:00:00,641,302,339,Leichte Eisregen,3,0,0.4,
,2021-03-16 18:00:00,509,195,314,Leichte Eisregen,3,-1,0.5,
,2021-03-16 19:00:00,286,137,149,Leichte Eisregen,2,-2,0.3,
,2021-03-16 20:00:00,184,96,88,Mäßige bis starke Schneefälle,1,-2,0.3,
,2021-03-16 21:00:00,70,39,31,Mäßige bis starke Schneefälle,0,-3,0.4,
,2021-03-16 22:00:00,64,34,30,Mäßige bis starke Schneefälle,1,-3,0.2,
,2021-03-16 23:00:00,48,29,19,Mäßige bis starke Schneefälle,1,-3,0,
,2021-03-17 00:00:00,19,7,12,Mäßige bis starke Schneefälle,1,-3,0.1,
,2021-03-17 01:00:00,10,5,5,Mäßige bis starke Schneefälle,1,-3,0,
,2021-03-17 02:00:00,6,2,4,Bedeckt,1,-3,0.5,
,2021-03-17 03:00:00,0,0,0,Bedeckt,1,-3,0.7,
,2021-03-17 04:00:00,6,4,2,Bedeckt,1,-3,0.3,
,2021-03-17 05:00:00,42,26,16,Starker Schneefall,1,-2,1.4,
,2021-03-17 06:00:00,125,84,41,Starker Schneefall,1,-2,1.9,
,2021-03-17 07:00:00,577,351,226,Starker Schneefall,1,-2,0.9,
,2021-03-17 08:00:00,622,347,275,Starker Schneefall,1,-2,1.2,
,2021-03-17 09:00:00,497,323,174,Starker Schneefall,1,-1,1.6,
,2021-03-17 10:00:00,359,203,156,Starker Schneefall,2,-1,0.8,
,2021-03-17 11:00:00,411,195,216,Starker Schneefall,2,-1,1,
,2021-03-17 12:00:00,503,201,302,Starker Schneefall,2,-1,1.4,
,2021-03-17 13:00:00,673,290,383,Starker Schneefall,3,-1,0.7,
,2021-03-17 14:00:00,513,278,235,Starker Schneefall,3,0,0.5,
,2021-03-17 15:00:00,562,295,267,Starker Schneefall,3,0,0.7,
,2021-03-17 16:00:00,684,355,329,Starker Schneefall,2,0,0.3,
,2021-03-17 17:00:00,730,332,398,Mäßige bis starke Schneefälle,2,-1,0.2,
,2021-03-17 18:00:00,439,187,252,Mäßige bis starke Schneefälle,1,-2,0.3,
,2021-03-17 19:00:00,249,98,151,Mäßige bis starke Schneefälle,0,-3,0.2,
,2021-03-17 20:00:00,152,63,89,Mäßige bis starke Schneefälle,-1,-4,0.1,
,2021-03-17 21:00:00,71,41,30,Mäßige bis starke Schneefälle,-2,-5,0.1,
,2021-03-17 22:00:00,49,27,22,Mäßige bis starke Schneefälle,-2,-5,0.1,
,2021-03-17 23:00:00,42,22,20,Starker Schneefall,-2,-4,0.1,
,2021-03-18 00:00:00,18,12,6,Starker Schneefall,-2,-4,0.3,
,2021-03-18 01:00:00,7,3,4,Starker Schneefall,-2,-5,0.1,
,2021-03-18 02:00:00,4,3,1,Stellenweise starker Schneefall,-3,-5,0,
,2021-03-18 03:00:00,4,3,1,Stellenweise starker Schneefall,-3,-6,0,
,2021-03-18 04:00:00,7,4,3,Stellenweise starker Schneefall,-3,-5,0,
,2021-03-18 05:00:00,40,26,14,Leichter Nebel,-3,-5,0,
,2021-03-18 06:00:00,148,92,56,Leichter Nebel,-3,-4,0,
,2021-03-18 07:00:00,710,425,285,Leichter Nebel,-2,-3,0,
,2021-03-18 08:00:00,614,368,246,Leichter Schneefall,-1,-1,0,
,2021-03-18 09:00:00,513,295,218,Leichter Schneefall,0,0,0,
,2021-03-18 10:00:00,374,199,175,Leichter Schneefall,1,1,0,
,2021-03-18 11:00:00,446,236,210,Bedeckt,3,2,0,
,2021-03-18 12:00:00,537,241,296,Bedeckt,4,4,0,
,2021-03-18 13:00:00,695,325,370,Bedeckt,4,3,0,
,2021-03-18 14:00:00,545,264,281,Bedeckt,4,3,0.1,
,2021-03-18 15:00:00,624,319,305,Bedeckt,4,3,0.1,
,2021-03-18 16:00:00,743,359,384,Bedeckt,3,2,0,
,2021-03-18 17:00:00,778,353,425,Mäßige bis starke Schneefälle,3,1,0.1,
,2021-03-18 18:00:00,602,269,333,Mäßige bis starke Schneefälle,2,-1,0.2,
,2021-03-18 19:00:00,334,168,166,Mäßige bis starke Schneefälle,1,-1,0.1,
,2021-03-18 20:00:00,174,82,92,Starker Schneefall,1,-1,0.5,
,2021-03-18 21:00:00,97,49,48,Starker Schneefall,0,-2,0.6,
,2021-03-18 22:00:00,80,44,36,Starker Schneefall,0,-2,0.3,
,2021-03-18 23:00:00,67,21,46,Mäßige bis starke Schneefälle,-1,-2,0.1,
,2021-03-19 00:00:00,45,28,17,Mäßige bis starke Schneefälle,-1,-2,0.1,
,2021-03-19 01:00:00,19,12,7,Mäßige bis starke Schneefälle,-1,-2,0.1,
,2021-03-19 02:00:00,9,5,4,Mäßige bis starke Schneefälle,-2,-2,0,
,2021-03-19 03:00:00,2,2,0,Mäßige bis starke Schneefälle,-2,-3,0,
,2021-03-19 04:00:00,8,5,3,Mäßige bis starke Schneefälle,-2,-3,0,
,2021-03-19 05:00:00,45,23,22,Leicht bewölkt,-2,-3,0,
,2021-03-19 06:00:00,144,90,54,Leicht bewölkt,-2,-3,0,
,2021-03-19 07:00:00,703,422,281,Leicht bewölkt,-1,-3,0,
,2021-03-19 08:00:00,654,377,277,Bewölkt,0,-2,0,
,2021-03-19 09:00:00,614,372,242,Bewölkt,1,-1,0,
,2021-03-19 10:00:00,541,307,234,Bewölkt,2,0,0,
,2021-03-19 11:00:00,607,294,313,Leichter Schneefall,3,1,0,
,2021-03-19 12:00:00,700,304,396,Leichter Schneefall,4,2,0,
,2021-03-19 13:00:00,792,320,472,Leichter Schneefall,4,2,0,
,2021-03-19 14:00:00,661,349,312,Bewölkt,5,2,0.1,
,2021-03-19 15:00:00,691,344,347,Bewölkt,5,2,0.2,
,2021-03-19 16:00:00,492,220,272,Bewölkt,4,1,0.1,
,2021-03-19 17:00:00,407,172,235,Stellenweiser Regenfall,3,-1,0.1,
,2021-03-19 18:00:00,385,170,215,Stellenweiser Regenfall,2,-3,0.1,
,2021-03-19 19:00:00,277,135,142,Stellenweiser Regenfall,1,-3,0,
,2021-03-19 20:00:00,164,84,80,Leicht bewölkt,0,-4,0,
,2021-03-19 21:00:00,64,31,33,Leicht bewölkt,0,-5,0,
,2021-03-19 22:00:00,57,28,29,Leicht bewölkt,-1,-6,0,
,2021-03-19 23:00:00,65,31,34,Mäßige bis starke Schneefälle,-1,-6,0.1,
,2021-03-20 00:00:00,47,33,14,Mäßige bis starke Schneefälle,-1,-6,0.1,
,2021-03-20 01:00:00,50,23,27,Mäßige bis starke Schneefälle,-2,-6,0.1,
,2021-03-20 02:00:00,32,15,17,Stellenweise mäßiger Schneefall,-2,-7,0,
,2021-03-20 03:00:00,12,6,6,Stellenweise mäßiger Schneefall,-2,-7,0,
,2021-03-20 04:00:00,17,12,5,Stellenweise mäßiger Schneefall,-3,-7,0,
,2021-03-20 05:00:00,20,7,13,Leichter Schneefall,-3,-7,0.1,
,2021-03-20 06:00:00,37,20,17,Leichter Schneefall,-3,-8,0.1,
,2021-03-20 07:00:00,61,28,33,Leichter Schneefall,-2,-7,0,
,2021-03-20 08:00:00,149,67,82,Starker Schneefall,-2,-7,0.1,
,2021-03-20 09:00:00,288,176,112,Starker Schneefall,-2,-7,0.1,
,2021-03-20 10:00:00,357,190,167,Starker Schneefall,-1,-6,0,
,2021-03-20 11:00:00,334,188,146,Stellenweise mäßiger Schneefall,0,-4,0.1,
,2021-03-20 12:00:00,429,235,194,Stellenweise mäßiger Schneefall,1,-3,0.1,
,2021-03-20 13:00:00,448,197,251,Stellenweise mäßiger Schneefall,1,-3,0,
,2021-03-20 14:00:00,1217,260,957,Stellenweise mäßiger Schneefall,1,-2,0,
,2021-03-20 15:00:00,617,299,318,Stellenweise mäßiger Schneefall,2,-2,0,
,2021-03-20 16:00:00,446,211,235,Stellenweise mäßiger Schneefall,1,-2,0,
,2021-03-20 17:00:00,465,225,240,Leicht bewölkt,1,-2,0,
,2021-03-20 18:00:00,415,213,202,Leicht bewölkt,0,-1,0,
,2021-03-20 19:00:00,206,108,98,Leicht bewölkt,-1,-3,0,
,2021-03-20 20:00:00,169,83,86,Leicht bewölkt,-2,-4,0,
,2021-03-20 21:00:00,93,51,42,Leicht bewölkt,-3,-5,0,
,2021-03-20 22:00:00,70,47,23,Leicht bewölkt,-3,-5,0,
,2021-03-20 23:00:00,57,28,29,Leicht bewölkt,-3,-5,0,
,2021-03-21 00:00:00,86,41,45,Leicht bewölkt,-4,-5,0,
,2021-03-21 01:00:00,37,18,19,Leicht bewölkt,-4,-4,0,
,2021-03-21 02:00:00,20,9,11,Leicht bewölkt,-3,-4,0,
,2021-03-21 03:00:00,10,5,5,Leicht bewölkt,-3,-4,0,
,2021-03-21 04:00:00,8,2,6,Leicht bewölkt,-3,-4,0,
,2021-03-21 05:00:00,14,7,7,Bedeckt,-3,-3,0,
,2021-03-21 06:00:00,23,13,10,Bedeckt,-3,-3,0,
,2021-03-21 07:00:00,27,14,13,Bedeckt,-2,-2,0,
,2021-03-21 08:00:00,52,26,26,Leicht bewölkt,-1,-1,0,
,2021-03-21 09:00:00,130,78,52,Leicht bewölkt,1,0,0,
,2021-03-21 10:00:00,152,76,76,Leicht bewölkt,2,1,0,
,2021-03-21 11:00:00,220,95,125,Leicht bewölkt,3,2,0,
,2021-03-21 12:00:00,190,105,85,Leicht bewölkt,5,4,0,
,2021-03-21 13:00:00,211,117,94,Leicht bewölkt,5,4,0,
,2021-03-21 14:00:00,256,128,128,Leicht bewölkt,6,5,0,
,2021-03-21 15:00:00,315,172,143,Leicht bewölkt,6,5,0,
,2021-03-21 16:00:00,265,142,123,Leicht bewölkt,5,5,0,
,2021-03-21 17:00:00,286,160,126,Leicht bewölkt,4,4,0.1,
,2021-03-21 18:00:00,216,138,78,Leicht bewölkt,4,3,0.1,
,2021-03-21 19:00:00,149,81,68,Leicht bewölkt,3,3,0,
,2021-03-21 20:00:00,98,52,46,Starker Schneefall,2,2,0.1,
,2021-03-21 21:00:00,75,33,42,Starker Schneefall,2,1,0.1,
,2021-03-21 22:00:00,38,16,22,Starker Schneefall,2,1,0.1,
,2021-03-21 23:00:00,23,8,15,Starker Schneefall,2,2,0.1,
,2021-03-22 00:00:00,15,7,8,Starker Schneefall,2,2,0.2,
,2021-03-22 01:00:00,7,5,2,Starker Schneefall,2,1,0.1,
,2021-03-22 02:00:00,6,5,1,Starker Schneefall,1,1,0.1,
,2021-03-22 03:00:00,3,2,1,Starker Schneefall,1,0,0.1,
,2021-03-22 04:00:00,4,1,3,Starker Schneefall,1,0,0.1,
,2021-03-22 05:00:00,45,28,17,Starker Schneefall,1,-1,0.1,
,2021-03-22 06:00:00,155,90,65,Starker Schneefall,1,-2,0.1,
,2021-03-22 07:00:00,755,478,277,Starker Schneefall,1,-1,0,
,2021-03-22 08:00:00,688,392,296,Mäßige bis starke Schneefälle,2,0,0,
,2021-03-22 09:00:00,556,314,242,Mäßige bis starke Schneefälle,2,0,0,
,2021-03-22 10:00:00,371,236,135,Mäßige bis starke Schneefälle,3,1,0,
,2021-03-22 11:00:00,489,239,250,Mäßige bis starke Schneefälle,4,2,0.1,
,2021-03-22 12:00:00,614,269,345,Mäßige bis starke Schneefälle,5,3,0.1,
,2021-03-22 13:00:00,754,312,442,Mäßige bis starke Schneefälle,5,3,0,
,2021-03-22 14:00:00,497,285,212,Leichte Eisregen,5,3,0.1,
,2021-03-22 15:00:00,646,324,322,Leichte Eisregen,6,3,0.1,
,2021-03-22 16:00:00,753,381,372,Leichte Eisregen,5,3,0,
,2021-03-22 17:00:00,734,345,389,Stellenweiser Regenfall,5,3,0.1,
,2021-03-22 18:00:00,542,226,316,Stellenweiser Regenfall,5,4,0.1,
,2021-03-22 19:00:00,287,128,159,Stellenweiser Regenfall,4,3,0,
,2021-03-22 20:00:00,164,84,80,Mäßige bis starke Schneefälle,3,2,0,
,2021-03-22 21:00:00,102,47,55,Mäßige bis starke Schneefälle,2,2,0,
,2021-03-22 22:00:00,53,28,25,Mäßige bis starke Schneefälle,1,1,0,
,2021-03-22 23:00:00,36,20,16,Bewölkt,0,0,0,
,2021-03-23 00:00:00,21,11,10,Bewölkt,0,-2,0,
,2021-03-23 01:00:00,12,8,4,Bewölkt,-1,-2,0,
,2021-03-23 02:00:00,5,5,0,Leicht bewölkt,-1,-2,0,
,2021-03-23 03:00:00,1,1,0,Leicht bewölkt,-1,-2,0,
,2021-03-23 04:00:00,2,0,2,Leicht bewölkt,-1,-2,0,
,2021-03-23 05:00:00,50,30,20,Leicht bewölkt,-1,-2,0,
,2021-03-23 06:00:00,176,111,65,Leicht bewölkt,-1,-2,0,
,2021-03-23 07:00:00,805,473,332,Leicht bewölkt,0,-1,0,
,2021-03-23 08:00:00,745,413,332,Leicht bewölkt,1,0,0,
,2021-03-23 09:00:00,562,351,211,Leicht bewölkt,2,1,0,
,2021-03-23 10:00:00,473,253,220,Leicht bewölkt,4,3,0,
,2021-03-23 11:00:00,567,292,275,Leicht bewölkt,5,4,0,
,2021-03-23 12:00:00,674,304,370,Leicht bewölkt,6,5,0,
,2021-03-23 13:00:00,924,398,526,Leicht bewölkt,6,5,0,
,2021-03-23 14:00:00,763,399,364,Leicht bewölkt,7,6,0,
,2021-03-23 15:00:00,861,429,432,Leicht bewölkt,7,6,0,
,2021-03-23 16:00:00,883,430,453,Leicht bewölkt,6,5,0,
,2021-03-23 17:00:00,931,450,481,Leicht bewölkt,6,5,0,
,2021-03-23 18:00:00,756,324,432,Leicht bewölkt,5,5,0,
,2021-03-23 19:00:00,382,190,192,Leicht bewölkt,4,3,0,
,2021-03-23 20:00:00,205,93,112,Bewölkt,3,2,0,
,2021-03-23 21:00:00,116,53,63,Bewölkt,1,1,0,
,2021-03-23 22:00:00,75,35,40,Bewölkt,1,0,0,
,2021-03-23 23:00:00,42,27,15,Leicht bewölkt,0,0,0,
,2021-03-24 00:00:00,20,11,9,Leicht bewölkt,-1,-1,0,
,2021-03-24 01:00:00,12,7,5,Leicht bewölkt,-1,-1,0,
,2021-03-24 02:00:00,10,9,1,Leicht bewölkt,-1,-1,0,
,2021-03-24 03:00:00,1,1,0,Leicht bewölkt,-2,-2,0,
,2021-03-24 04:00:00,9,6,3,Leicht bewölkt,-1,-1,0,
,2021-03-24 05:00:00,44,23,21,Leicht bewölkt,-1,-1,0,
,2021-03-24 06:00:00,183,110,73,Leicht bewölkt,-1,-1,0,
,2021-03-24 07:00:00,779,489,290,Leicht bewölkt,1,1,0,
,2021-03-24 08:00:00,738,405,333,Leicht bewölkt,3,3,0,
,2021-03-24 09:00:00,683,433,250,Leicht bewölkt,5,5,0,
,2021-03-24 10:00:00,511,290,221,Leicht bewölkt,7,7,0,
,2021-03-24 11:00:00,640,319,321,Leicht bewölkt,10,10,0,
,2021-03-24 12:00:00,785,365,420,Leicht bewölkt,12,12,0,
,2021-03-24 13:00:00,999,483,516,Leicht bewölkt,12,12,0,
,2021-03-24 14:00:00,853,429,424,Leicht bewölkt,12,12,0,
,2021-03-24 15:00:00,956,443,513,Leicht bewölkt,12,13,0,
,2021-03-24 16:00:00,1063,526,537,Leicht bewölkt,11,12,0,
,2021-03-24 17:00:00,1063,501,562,Leicht bewölkt,11,11,0,
,2021-03-24 18:00:00,845,374,471,Leicht bewölkt,10,10,0,
,2021-03-24 19:00:00,444,215,229,Leicht bewölkt,8,8,0,
,2021-03-24 20:00:00,237,109,128,Leicht bewölkt,7,7,0,
,2021-03-24 21:00:00,117,55,62,Leicht bewölkt,6,6,0,
,2021-03-24 22:00:00,103,54,49,Leicht bewölkt,5,5,0,
,2021-03-24 23:00:00,56,26,30,Leicht bewölkt,5,4,0,
,2021-03-25 00:00:00,44,29,15,Leicht bewölkt,4,3,0,
,2021-03-25 01:00:00,16,7,9,Leicht bewölkt,3,2,0,
,2021-03-25 02:00:00,5,2,3,Leicht bewölkt,1,0,0,
,2021-03-25 03:00:00,7,6,1,Leicht bewölkt,0,-1,0,
,2021-03-25 04:00:00,9,5,4,Leicht bewölkt,0,-1,0,
,2021-03-25 05:00:00,51,29,22,Bedeckt,0,-1,0,
,2021-03-25 06:00:00,180,110,70,Bedeckt,0,-1,0,
,2021-03-25 07:00:00,859,549,310,Bedeckt,2,1,0,
,2021-03-25 08:00:00,782,438,344,Bedeckt,4,3,0,
,2021-03-25 09:00:00,626,313,313,Bedeckt,6,5,0,
,2021-03-25 10:00:00,454,237,217,Bedeckt,7,7,0,
,2021-03-25 11:00:00,563,270,293,Leicht bewölkt,9,9,0,
,2021-03-25 12:00:00,742,340,402,Leicht bewölkt,11,11,0,
,2021-03-25 13:00:00,829,355,474,Leicht bewölkt,12,12,0,
,2021-03-25 14:00:00,829,438,391,Leicht bewölkt,12,12,0,
,2021-03-25 15:00:00,859,417,442,Leicht bewölkt,13,13,0,
,2021-03-25 16:00:00,934,425,509,Leicht bewölkt,12,12,0,
,2021-03-25 17:00:00,879,437,442,Leicht bewölkt,12,12,0,
,2021-03-25 18:00:00,748,333,415,Leicht bewölkt,11,11,0,
,2021-03-25 19:00:00,462,205,257,Leicht bewölkt,10,10,0,
,2021-03-25 20:00:00,234,106,128,Bedeckt,9,9,0,
,2021-03-25 21:00:00,112,55,57,Bedeckt,8,8,0,
,2021-03-25 22:00:00,101,53,48,Bedeckt,7,6,0,
,2021-03-25 23:00:00,82,41,41,Leicht bewölkt,5,5,0,
,2021-03-26 00:00:00,32,18,14,Leicht bewölkt,4,3,0,
,2021-03-26 01:00:00,27,13,14,Leicht bewölkt,3,2,0,
,2021-03-26 02:00:00,6,5,1,Leicht bewölkt,2,1,0,
,2021-03-26 03:00:00,3,0,3,Leicht bewölkt,1,0,0,
,2021-03-26 04:00:00,5,4,1,Leicht bewölkt,1,0,0,
,2021-03-26 05:00:00,44,21,23,Leicht bewölkt,1,0,0,
,2021-03-26 06:00:00,153,92,61,Leicht bewölkt,1,0,0,
,2021-03-26 07:00:00,780,510,270,Leicht bewölkt,3,3,0,
,2021-03-26 08:00:00,738,421,317,Leicht bewölkt,5,5,0,
,2021-03-26 09:00:00,741,433,308,Leicht bewölkt,8,8,0,
,2021-03-26 10:00:00,598,336,262,Leicht bewölkt,9,9,0,
,2021-03-26 11:00:00,693,342,351,Leicht bewölkt,11,11,0,
,2021-03-26 12:00:00,898,405,493,Leicht bewölkt,13,13,0,
,2021-03-26 13:00:00,1018,402,616,Leicht bewölkt,13,13,0,
,2021-03-26 14:00:00,928,461,467,Leicht bewölkt,14,13,0,
,2021-03-26 15:00:00,857,396,461,Leicht bewölkt,14,14,0,
,2021-03-26 16:00:00,839,426,413,Leicht bewölkt,14,13,0,
,2021-03-26 17:00:00,877,407,470,Leicht bewölkt,13,13,0,
,2021-03-26 18:00:00,688,320,368,Leicht bewölkt,13,12,0,
,2021-03-26 19:00:00,459,235,224,Leicht bewölkt,12,11,0,
,2021-03-26 20:00:00,225,121,104,Leicht bewölkt,11,10,0,
,2021-03-26 21:00:00,121,65,56,Leicht bewölkt,10,10,0,
,2021-03-26 22:00:00,139,79,60,Leicht bewölkt,8,8,0,
,2021-03-26 23:00:00,79,33,46,Stellenweiser Regenfall,7,6,0.1,
,2021-03-27 00:00:00,69,41,28,Stellenweiser Regenfall,6,5,0.1,
,2021-03-27 01:00:00,45,20,25,Stellenweiser Regenfall,6,5,0.1,
,2021-03-27 02:00:00,45,17,28,Stellenweiser Nieselregen,6,4,0.1,
,2021-03-27 03:00:00,17,9,8,Stellenweiser Nieselregen,6,4,0.1,
,2021-03-27 04:00:00,11,9,2,Stellenweiser Nieselregen,6,4,0.1,
,2021-03-27 05:00:00,14,4,10,Nieselregen,6,5,0.1,
,2021-03-27 06:00:00,32,18,14,Nieselregen,7,5,0.1,
,2021-03-27 07:00:00,40,23,17,Nieselregen,7,5,0,
,2021-03-27 08:00:00,140,79,61,Stellenweiser Regenfall,7,6,0,
,2021-03-27 09:00:00,289,149,140,Stellenweiser Regenfall,8,6,0,
,2021-03-27 10:00:00,410,223,187,Stellenweiser Regenfall,8,7,0,
,2021-03-27 11:00:00,454,231,223,Stellenweiser Regenfall,9,8,0,
,2021-03-27 12:00:00,456,241,215,Stellenweiser Regenfall,9,9,0,
,2021-03-27 13:00:00,529,279,250,Stellenweiser Regenfall,10,9,0,
,2021-03-27 14:00:00,1021,210,811,Stellenweiser Regenfall,11,10,0,
,2021-03-27 15:00:00,520,240,280,Stellenweiser Regenfall,11,11,0,
,2021-03-27 16:00:00,512,279,233,Stellenweiser Regenfall,11,11,0,
,2021-03-27 17:00:00,487,238,249,Leicht bewölkt,11,11,0,
,2021-03-27 18:00:00,437,231,206,Leicht bewölkt,11,11,0,
,2021-03-27 19:00:00,303,147,156,Leicht bewölkt,10,10,0,
,2021-03-27 20:00:00,150,82,68,Leicht bewölkt,9,9,0,
,2021-03-27 21:00:00,110,60,50,Leicht bewölkt,9,9,0,
,2021-03-27 22:00:00,67,34,33,Leicht bewölkt,8,7,0,
,2021-03-27 23:00:00,79,37,42,Leicht bewölkt,6,6,0,
,2021-03-28 00:00:00,70,39,31,Leicht bewölkt,5,5,0,
,2021-03-28 01:00:00,53,28,25,Leicht bewölkt,4,4,0,
,2021-03-28 03:00:00,,,,weather_condition_null,,,,
,2021-03-28 03:00:00,36,20,16,Leicht bewölkt,3,2,0,
,2021-03-28 04:00:00,19,17,2,Leicht bewölkt,3,2,0,
,2021-03-28 05:00:00,11,7,4,Leicht bewölkt,3,2,0,
,2021-03-28 06:00:00,27,17,10,Leicht bewölkt,3,2,0,
,2021-03-28 07:00:00,35,14,21,Leicht bewölkt,5,5,0,
,2021-03-28 08:00:00,66,35,31,Leicht bewölkt,7,7,0,
,2021-03-28 09:00:00,141,65,76,Leicht bewölkt,10,10,0,
,2021-03-28 10:00:00,256,130,126,Leicht bewölkt,12,12,0,
,2021-03-28 11:00:00,423,199,224,Leicht bewölkt,14,14,0,
,2021-03-28 12:00:00,498,249,249,Leicht bewölkt,16,16,0,
,2021-03-28 13:00:00,687,310,377,Leicht bewölkt,17,17,0,
,2021-03-28 14:00:00,774,391,383,Leicht bewölkt,17,17,0,
,2021-03-28 15:00:00,745,393,352,Leicht bewölkt,18,18,0,
,2021-03-28 16:00:00,745,406,339,Leicht bewölkt,17,17,0,
,2021-03-28 17:00:00,743,440,303,Leicht bewölkt,16,16,0,
,2021-03-28 18:00:00,602,311,291,Leicht bewölkt,15,15,0,
,2021-03-28 19:00:00,360,206,154,Leicht bewölkt,14,14,0,
,2021-03-28 20:00:00,245,122,123,Leicht bewölkt,12,12,0,
,2021-03-28 21:00:00,97,55,42,Leicht bewölkt,11,11,0,
,2021-03-28 22:00:00,71,33,38,Leicht bewölkt,9,8,0,
,2021-03-28 23:00:00,26,12,14,Bewölkt,6,5,0,
,2021-03-29 00:00:00,21,15,6,Bewölkt,4,2,0,
,2021-03-29 01:00:00,10,8,2,Bewölkt,3,2,0,
,2021-03-29 02:00:00,2,0,2,Leicht bewölkt,3,2,0,
,2021-03-29 03:00:00,2,2,0,Leicht bewölkt,3,1,0,
,2021-03-29 04:00:00,6,4,2,Leicht bewölkt,3,2,0,
,2021-03-29 05:00:00,52,26,26,Leicht bewölkt,3,2,0,
,2021-03-29 06:00:00,154,100,54,Leicht bewölkt,3,2,0,
,2021-03-29 07:00:00,760,444,316,Leicht bewölkt,5,4,0,
,2021-03-29 08:00:00,757,428,329,Leicht bewölkt,7,7,0,
,2021-03-29 09:00:00,665,397,268,Leicht bewölkt,9,9,0,
,2021-03-29 10:00:00,456,233,223,Leicht bewölkt,11,11,0,
,2021-03-29 11:00:00,615,279,336,Leicht bewölkt,13,13,0,
,2021-03-29 12:00:00,760,382,378,Leicht bewölkt,15,15,0,
,2021-03-29 13:00:00,953,426,527,Leicht bewölkt,16,16,0,
,2021-03-29 14:00:00,788,414,374,Leicht bewölkt,16,16,0,
,2021-03-29 15:00:00,974,513,461,Leicht bewölkt,17,17,0,
,2021-03-29 16:00:00,963,468,495,Leicht bewölkt,17,17,0,
,2021-03-29 17:00:00,1043,532,511,Leicht bewölkt,16,16,0,
,2021-03-29 18:00:00,815,372,443,Leicht bewölkt,16,16,0,
,2021-03-29 19:00:00,570,298,272,Leicht bewölkt,15,15,0,
,2021-03-29 20:00:00,323,154,169,Leicht bewölkt,14,14,0,
,2021-03-29 21:00:00,148,71,77,Leicht bewölkt,13,13,0,
,2021-03-29 22:00:00,84,42,42,Leicht bewölkt,11,11,0,
,2021-03-29 23:00:00,43,23,20,Leicht bewölkt,9,9,0,
,2021-03-30 00:00:00,34,15,19,Leicht bewölkt,8,8,0,
,2021-03-30 01:00:00,8,3,5,Leicht bewölkt,7,7,0,
,2021-03-30 02:00:00,4,1,3,Leicht bewölkt,6,6,0,
,2021-03-30 03:00:00,0,0,0,Leicht bewölkt,5,5,0,
,2021-03-30 04:00:00,12,5,7,Leicht bewölkt,5,5,0,
,2021-03-30 05:00:00,59,32,27,Leicht bewölkt,5,5,0,
,2021-03-30 06:00:00,174,114,60,Leicht bewölkt,5,5,0,
,2021-03-30 07:00:00,814,496,318,Leicht bewölkt,7,7,0,
,2021-03-30 08:00:00,805,470,335,Leicht bewölkt,9,9,0,
,2021-03-30 09:00:00,715,399,316,Leicht bewölkt,11,11,0,
,2021-03-30 10:00:00,607,352,255,Leicht bewölkt,12,12,0,
,2021-03-30 11:00:00,714,378,336,Leicht bewölkt,14,14,0,
,2021-03-30 12:00:00,836,372,464,Leicht bewölkt,16,16,0,
,2021-03-30 13:00:00,1013,420,593,Leicht bewölkt,16,16,0,
,2021-03-30 14:00:00,838,435,403,Bewölkt,17,17,0,
,2021-03-30 15:00:00,1038,530,508,Bewölkt,18,18,0,
,2021-03-30 16:00:00,1145,557,588,Bewölkt,17,17,0,
,2021-03-30 17:00:00,1084,566,518,Leicht bewölkt,16,16,0,
,2021-03-30 18:00:00,921,428,493,Leicht bewölkt,15,15,0,
,2021-03-30 19:00:00,683,342,341,Leicht bewölkt,15,15,0,
,2021-03-30 20:00:00,381,180,201,Leicht bewölkt,14,14,0,
,2021-03-30 21:00:00,199,83,116,Leicht bewölkt,13,13,0,
,2021-03-30 22:00:00,134,68,66,Leicht bewölkt,11,11,0,
,2021-03-30 23:00:00,55,30,25,Leicht bewölkt,10,10,0,
,2021-03-31 00:00:00,29,9,20,Leicht bewölkt,8,8,0,
,2021-03-31 01:00:00,14,11,3,Leicht bewölkt,8,8,0,
,2021-03-31 02:00:00,7,2,5,Leicht bewölkt,7,7,0,
,2021-03-31 03:00:00,13,9,4,Leicht bewölkt,6,6,0,
,2021-03-31 04:00:00,11,9,2,Leicht bewölkt,6,6,0,
,2021-03-31 05:00:00,47,27,20,Leicht bewölkt,6,6,0,
,2021-03-31 06:00:00,160,101,59,Leicht bewölkt,6,6,0,
,2021-03-31 07:00:00,726,455,271,Leicht bewölkt,8,8,0,
,2021-03-31 08:00:00,833,468,365,Leicht bewölkt,10,10,0,
,2021-03-31 09:00:00,635,393,242,Leicht bewölkt,12,12,0,
,2021-03-31 10:00:00,560,302,258,Leicht bewölkt,14,14,0,
,2021-03-31 11:00:00,688,363,325,Leicht bewölkt,15,15,0,
,2021-03-31 12:00:00,917,423,494,Leicht bewölkt,17,17,0,
,2021-03-31 13:00:00,990,433,557,Leicht bewölkt,18,18,0,
,2021-03-31 14:00:00,915,475,440,Leicht bewölkt,19,19,0,
,2021-03-31 15:00:00,962,504,458,Leicht bewölkt,19,19,0,
,2021-03-31 16:00:00,1091,576,515,Leicht bewölkt,19,19,0,
,2021-03-31 17:00:00,1155,568,587,Leicht bewölkt,19,19,0,
,2021-03-31 18:00:00,903,459,444,Leicht bewölkt,19,19,0,
,2021-03-31 19:00:00,683,353,330,Leicht bewölkt,17,17,0,
,2021-03-31 20:00:00,420,199,221,Leicht bewölkt,16,16,0,
,2021-03-31 21:00:00,231,99,132,Leicht bewölkt,15,15,0,
,2021-03-31 22:00:00,127,55,72,Leicht bewölkt,14,14,0,
,2021-03-31 23:00:00,96,32,64,Leicht bewölkt,12,12,0,
,2021-04-01 00:00:00,55,31,24,Leicht bewölkt,11,11,0,
,2021-04-01 01:00:00,29,11,18,Leicht bewölkt,9,9,0,
,2021-04-01 02:00:00,21,9,12,Leicht bewölkt,8,8,0,
,2021-04-01 03:00:00,10,3,7,Leicht bewölkt,7,7,0,
,2021-04-01 04:00:00,12,9,3,Leicht bewölkt,7,7,0,
,2021-04-01 05:00:00,50,29,21,Leicht bewölkt,7,7,0,
,2021-04-01 06:00:00,152,99,53,Leicht bewölkt,7,7,0,
,2021-04-01 07:00:00,402,237,165,Leicht bewölkt,9,9,0,
,2021-04-01 08:00:00,641,385,256,Leicht bewölkt,11,11,0,
,2021-04-01 09:00:00,557,328,229,Leicht bewölkt,13,13,0,
,2021-04-01 10:00:00,675,376,299,Leicht bewölkt,15,15,0,
,2021-04-01 11:00:00,723,383,340,Leicht bewölkt,17,17,0,
,2021-04-01 12:00:00,986,481,505,Leicht bewölkt,19,19,0,
,2021-04-01 13:00:00,797,367,430,Leicht bewölkt,20,20,0,
,2021-04-01 14:00:00,916,490,426,Leicht bewölkt,20,20,0,
,2021-04-01 15:00:00,890,439,451,Leicht bewölkt,21,21,0,
,2021-04-01 16:00:00,1025,546,479,Leicht bewölkt,20,20,0,
,2021-04-01 17:00:00,977,498,479,Leicht bewölkt,20,20,0.3,
,2021-04-01 18:00:00,859,416,443,Leicht bewölkt,19,19,0.4,
,2021-04-01 19:00:00,439,206,233,Leicht bewölkt,18,18,0.2,
,2021-04-01 20:00:00,291,145,146,Nieselregen mit Gewitter,17,17,0.5,
,2021-04-01 21:00:00,155,83,72,Nieselregen mit Gewitter,16,16,0.6,
,2021-04-01 22:00:00,78,40,38,Nieselregen mit Gewitter,14,14,0.3,
,2021-04-01 23:00:00,89,44,45,Stellenweiser Regenfall,13,13,0.4,
,2021-04-02 00:00:00,49,25,24,Stellenweiser Regenfall,11,11,0.7,
,2021-04-02 01:00:00,39,19,20,Stellenweiser Regenfall,10,10,0.4,
,2021-04-02 02:00:00,19,15,4,Stellenweiser Regenfall,10,10,0.1,
,2021-04-02 03:00:00,9,4,5,Stellenweiser Regenfall,9,9,0.1,
,2021-04-02 04:00:00,6,2,4,Stellenweiser Regenfall,9,9,0.1,
,2021-04-02 05:00:00,8,2,6,Leicht bewölkt,9,9,0,
,2021-04-02 06:00:00,33,20,13,Leicht bewölkt,9,9,0,
,2021-04-02 07:00:00,38,16,22,Leicht bewölkt,10,10,0,
,2021-04-02 08:00:00,103,56,47,Leicht bewölkt,11,10,0,
,2021-04-02 09:00:00,196,100,96,Leicht bewölkt,12,11,0,
,2021-04-02 10:00:00,273,140,133,Leicht bewölkt,12,11,0,
,2021-04-02 11:00:00,420,195,225,Bedeckt,12,11,0,
,2021-04-02 12:00:00,497,198,299,Bedeckt,12,11,0,
,2021-04-02 13:00:00,567,272,295,Bedeckt,12,11,0,
,2021-04-02 14:00:00,706,382,324,Bedeckt,11,10,0,
,2021-04-02 15:00:00,747,364,383,Bedeckt,11,10,0,
,2021-04-02 16:00:00,785,468,317,Bedeckt,10,9,0,
,2021-04-02 17:00:00,516,273,243,Bedeckt,10,9,0,
,2021-04-02 18:00:00,375,201,174,Bedeckt,9,9,0,
,2021-04-02 19:00:00,330,197,133,Bedeckt,9,8,0,
,2021-04-02 20:00:00,227,116,111,Nieselregen,8,8,0,
,2021-04-02 21:00:00,125,50,75,Nieselregen,8,7,0,
,2021-04-02 22:00:00,76,38,38,Nieselregen,7,6,0,
,2021-04-02 23:00:00,39,14,25,Stellenweiser Regenfall,6,5,0,
,2021-04-03 00:00:00,31,11,20,Stellenweiser Regenfall,5,4,0.1,
,2021-04-03 01:00:00,34,18,16,Stellenweiser Regenfall,5,3,0,
,2021-04-03 02:00:00,18,4,14,Stellenweiser Regenfall,4,2,0,
,2021-04-03 03:00:00,6,0,6,Stellenweiser Regenfall,3,1,0,
,2021-04-03 04:00:00,5,4,1,Stellenweiser Regenfall,3,1,0,
,2021-04-03 05:00:00,23,13,10,Leicht bewölkt,3,1,0,
,2021-04-03 06:00:00,38,25,13,Leicht bewölkt,3,1,0,
,2021-04-03 07:00:00,92,41,51,Leicht bewölkt,3,1,0,
,2021-04-03 08:00:00,205,101,104,Leicht bewölkt,4,2,0,
,2021-04-03 09:00:00,330,191,139,Leicht bewölkt,5,3,0,
,2021-04-03 10:00:00,433,235,198,Leicht bewölkt,5,3,0,
,2021-04-03 11:00:00,562,314,248,Bewölkt,6,4,0,
,2021-04-03 12:00:00,528,276,252,Bewölkt,7,5,0,
,2021-04-03 13:00:00,522,267,255,Bewölkt,7,5,0,
,2021-04-03 14:00:00,473,244,229,Leicht bewölkt,7,5,0.1,
,2021-04-03 15:00:00,449,218,231,Leicht bewölkt,7,5,0.1,
,2021-04-03 16:00:00,450,228,222,Leicht bewölkt,7,5,0.1,
,2021-04-03 17:00:00,359,177,182,Stellenweiser Regenfall,6,5,0.1,
,2021-04-03 18:00:00,421,233,188,Stellenweiser Regenfall,6,5,0.1,
,2021-04-03 19:00:00,198,85,113,Stellenweiser Regenfall,5,4,0.1,
,2021-04-03 20:00:00,176,86,90,Stellenweiser Regenfall,4,3,0,
,2021-04-03 21:00:00,69,32,37,Stellenweiser Regenfall,3,3,0,
,2021-04-03 22:00:00,60,33,27,Stellenweiser Regenfall,2,1,0,
,2021-04-03 23:00:00,88,49,39,Leicht bewölkt,1,-1,0,
,2021-04-04 00:00:00,46,31,15,Leicht bewölkt,0,-2,0,
,2021-04-04 01:00:00,30,17,13,Leicht bewölkt,0,-2,0,
,2021-04-04 02:00:00,16,6,10,Leicht bewölkt,-1,-3,0,
,2021-04-04 03:00:00,13,11,2,Leicht bewölkt,-1,-3,0,
,2021-04-04 04:00:00,14,12,2,Leicht bewölkt,0,-2,0,
,2021-04-04 05:00:00,12,8,4,Leicht bewölkt,0,-2,0,
,2021-04-04 06:00:00,29,20,9,Leicht bewölkt,1,-1,0,
,2021-04-04 07:00:00,41,21,20,Leicht bewölkt,2,1,0,
,2021-04-04 08:00:00,72,31,41,Leicht bewölkt,4,2,0,
,2021-04-04 09:00:00,160,83,77,Leicht bewölkt,6,4,0,
,2021-04-04 10:00:00,245,97,148,Leicht bewölkt,7,5,0,
,2021-04-04 11:00:00,308,145,163,Leicht bewölkt,8,6,0,
,2021-04-04 12:00:00,391,205,186,Leicht bewölkt,9,7,0,
,2021-04-04 13:00:00,492,206,286,Leicht bewölkt,10,8,0,
,2021-04-04 14:00:00,491,245,246,Leicht bewölkt,10,8,0,
,2021-04-04 15:00:00,520,300,220,Leicht bewölkt,11,9,0,
,2021-04-04 16:00:00,534,303,231,Leicht bewölkt,10,8,0,
,2021-04-04 17:00:00,489,253,236,Leicht bewölkt,9,8,0,
,2021-04-04 18:00:00,470,252,218,Leicht bewölkt,8,7,0,
,2021-04-04 19:00:00,337,184,153,Leicht bewölkt,7,6,0,
,2021-04-04 20:00:00,184,99,85,Leicht bewölkt,6,5,0,
,2021-04-04 21:00:00,88,53,35,Leicht bewölkt,4,4,0,
,2021-04-04 22:00:00,46,25,21,Leicht bewölkt,4,4,0,
,2021-04-04 23:00:00,47,24,23,Sonnig,4,4,0,
,2021-04-05 00:00:00,29,14,15,Sonnig,4,4,0,
,2021-04-05 01:00:00,18,13,5,Sonnig,3,2,0,
,2021-04-05 02:00:00,6,5,1,Sonnig,2,1,0,
,2021-04-05 03:00:00,0,0,0,Sonnig,1,-1,0,
,2021-04-05 04:00:00,5,3,2,Sonnig,1,-1,0,
,2021-04-05 05:00:00,7,2,5,Leicht bewölkt,1,-1,0,
,2021-04-05 06:00:00,26,16,10,Leicht bewölkt,1,-1,0,
,2021-04-05 07:00:00,31,14,17,Leicht bewölkt,3,1,0,
,2021-04-05 08:00:00,53,29,24,Bedeckt,5,3,0,
,2021-04-05 09:00:00,129,68,61,Bedeckt,7,5,0,
,2021-04-05 10:00:00,242,114,128,Bedeckt,9,6,0,
,2021-04-05 11:00:00,287,131,156,Leicht bewölkt,10,7,0,
,2021-04-05 12:00:00,324,182,142,Leicht bewölkt,11,9,0,
,2021-04-05 13:00:00,270,127,143,Leicht bewölkt,12,9,0,
,2021-04-05 14:00:00,346,172,174,Leicht bewölkt,12,9,0,
,2021-04-05 15:00:00,336,152,184,Leicht bewölkt,12,9,0,
,2021-04-05 16:00:00,275,144,131,Leicht bewölkt,11,9,0,
,2021-04-05 17:00:00,271,140,131,Bedeckt,10,8,0,
,2021-04-05 18:00:00,200,102,98,Bedeckt,9,8,0,
,2021-04-05 19:00:00,143,62,81,Bedeckt,8,7,0,
,2021-04-05 20:00:00,83,52,31,Bedeckt,6,6,0.9,
,2021-04-05 21:00:00,52,28,24,Bedeckt,5,5,1.2,
,2021-04-05 22:00:00,28,17,11,Bedeckt,3,3,0.6,
,2021-04-05 23:00:00,29,12,17,Stellenweise starker Schneefall,2,1,2.4,
,2021-04-06 00:00:00,14,10,4,Stellenweise starker Schneefall,0,0,4.7,
,2021-04-06 01:00:00,11,8,3,Stellenweise starker Schneefall,-1,-2,2.4,
,2021-04-06 02:00:00,6,2,4,Stellenweise starker Schneefall,-3,-3,0.9,
,2021-04-06 03:00:00,1,0,1,Stellenweise starker Schneefall,-4,-4,1.2,
,2021-04-06 04:00:00,9,5,4,Stellenweise starker Schneefall,-4,-5,0.6,
,2021-04-06 05:00:00,36,26,10,Stellenweise starker Schneefall,-4,-5,0.1,
,2021-04-06 06:00:00,122,75,47,Stellenweise starker Schneefall,-4,-5,0.1,
,2021-04-06 07:00:00,308,172,136,Stellenweise starker Schneefall,-3,-5,0.1,
,2021-04-06 08:00:00,412,256,156,Stellenweise starker Schneefall,-2,-4,0.1,
,2021-04-06 09:00:00,331,211,120,Stellenweise starker Schneefall,-1,-4,0.1,
,2021-04-06 10:00:00,313,177,136,Stellenweise starker Schneefall,-1,-3,0,
,2021-04-06 11:00:00,377,190,187,Mäßige bis starke Schneefälle,0,-3,0,
,2021-04-06 12:00:00,419,183,236,Mäßige bis starke Schneefälle,1,-2,0,
,2021-04-06 13:00:00,401,179,222,Mäßige bis starke Schneefälle,1,-2,0,
,2021-04-06 14:00:00,311,159,152,Bedeckt,1,-2,0.3,
,2021-04-06 15:00:00,317,175,142,Bedeckt,1,-2,0.4,
,2021-04-06 16:00:00,397,220,177,Bedeckt,0,-3,0.2,
,2021-04-06 17:00:00,425,187,238,Mäßige bis starke Schneefälle,0,-4,0.5,
,2021-04-06 18:00:00,361,159,202,Mäßige bis starke Schneefälle,-1,-5,0.7,
,2021-04-06 19:00:00,207,97,110,Mäßige bis starke Schneefälle,-1,-5,0.3,
,2021-04-06 20:00:00,130,66,64,Starker Schneefall,-2,-6,0.3,
,2021-04-06 21:00:00,93,48,45,Starker Schneefall,-3,-6,0.4,
,2021-04-06 22:00:00,74,36,38,Starker Schneefall,-3,-6,0.2,
,2021-04-06 23:00:00,42,23,19,Mäßige bis starke Schneefälle,-2,-7,0.1,
,2021-04-07 00:00:00,11,5,6,Mäßige bis starke Schneefälle,-2,-7,0.3,
,2021-04-07 01:00:00,15,8,7,Mäßige bis starke Schneefälle,-2,-7,0.1,
,2021-04-07 02:00:00,8,7,1,Starker Schneefall,-2,-7,0.3,
,2021-04-07 03:00:00,5,2,3,Starker Schneefall,-2,-7,0.4,
,2021-04-07 04:00:00,8,5,3,Starker Schneefall,-2,-7,0.2,
,2021-04-07 05:00:00,33,22,11,Starker Schneefall,-2,-7,0.6,
,2021-04-07 06:00:00,99,60,39,Starker Schneefall,-3,-7,0.8,
,2021-04-07 07:00:00,284,163,121,Starker Schneefall,-2,-7,0.4,
,2021-04-07 08:00:00,369,217,152,Stellenweise starker Schneefall,-1,-6,0.3,
,2021-04-07 09:00:00,328,203,125,Stellenweise starker Schneefall,-1,-6,0.4,
,2021-04-07 10:00:00,267,145,122,Stellenweise starker Schneefall,0,-6,0.2,
,2021-04-07 11:00:00,347,181,166,Mäßige bis starke Schneefälle,0,-5,0.1,
,2021-04-07 12:00:00,369,184,185,Mäßige bis starke Schneefälle,1,-5,0.1,
,2021-04-07 13:00:00,347,149,198,Mäßige bis starke Schneefälle,1,-4,0,
,2021-04-07 14:00:00,340,185,155,Bedeckt,1,-4,0.1,
,2021-04-07 15:00:00,387,184,203,Bedeckt,2,-3,0.1,
,2021-04-07 16:00:00,423,209,214,Bedeckt,1,-4,0.1,
,2021-04-07 17:00:00,460,213,247,Mäßige bis starke Schneefälle,1,-4,0,
,2021-04-07 18:00:00,394,179,215,Mäßige bis starke Schneefälle,1,-4,0,
,2021-04-07 19:00:00,214,110,104,Mäßige bis starke Schneefälle,0,-4,0,
,2021-04-07 20:00:00,174,80,94,Bewölkt,0,-5,0.1,
,2021-04-07 21:00:00,79,33,46,Bewölkt,0,-5,0.1,
,2021-04-07 22:00:00,72,33,39,Bewölkt,-1,-5,0.1,
,2021-04-07 23:00:00,52,25,27,Starker Schneefall,-1,-5,0.1,
,2021-04-08 00:00:00,19,9,10,Starker Schneefall,-1,-5,0.2,
,2021-04-08 01:00:00,13,9,4,Starker Schneefall,-2,-6,0.1,
,2021-04-08 02:00:00,7,2,5,Stellenweise mäßiger Schneefall,-3,-7,0,
,2021-04-08 03:00:00,3,3,0,Stellenweise mäßiger Schneefall,-4,-7,0,
,2021-04-08 04:00:00,8,7,1,Stellenweise mäßiger Schneefall,-4,-7,0,
,2021-04-08 05:00:00,47,25,22,Leicht bewölkt,-4,-7,0,
,2021-04-08 06:00:00,127,76,51,Leicht bewölkt,-4,-7,0,
,2021-04-08 07:00:00,343,208,135,Leicht bewölkt,-2,-5,0,
,2021-04-08 08:00:00,485,286,199,Leicht bewölkt,-1,-3,0,
,2021-04-08 09:00:00,420,246,174,Leicht bewölkt,1,-2,0,
,2021-04-08 10:00:00,362,194,168,Leicht bewölkt,2,0,0,
,2021-04-08 11:00:00,416,222,194,Leicht bewölkt,4,2,0,
,2021-04-08 12:00:00,535,262,273,Leicht bewölkt,5,4,0,
,2021-04-08 13:00:00,522,254,268,Leicht bewölkt,6,4,0,
,2021-04-08 14:00:00,620,336,284,Leicht bewölkt,7,5,0,
,2021-04-08 15:00:00,678,343,335,Leicht bewölkt,7,6,0,
,2021-04-08 16:00:00,753,371,382,Leicht bewölkt,7,6,0,
,2021-04-08 17:00:00,794,379,415,Leicht bewölkt,6,5,0,
,2021-04-08 18:00:00,669,283,386,Leicht bewölkt,5,5,0,
,2021-04-08 19:00:00,423,196,227,Leicht bewölkt,4,4,0,
,2021-04-08 20:00:00,247,122,125,Leicht bewölkt,2,2,0,
,2021-04-08 21:00:00,155,74,81,Leicht bewölkt,1,1,0,
,2021-04-08 22:00:00,91,38,53,Leicht bewölkt,0,0,0,
,2021-04-08 23:00:00,75,39,36,Leichter Nebel,-1,-2,0,
,2021-04-09 00:00:00,49,24,25,Leichter Nebel,-1,-3,0,
,2021-04-09 01:00:00,19,10,9,Leichter Nebel,-2,-4,0,
,2021-04-09 02:00:00,12,4,8,Leicht bewölkt,-3,-5,0,
,2021-04-09 03:00:00,5,2,3,Leicht bewölkt,-4,-6,0,
,2021-04-09 04:00:00,9,6,3,Leicht bewölkt,-3,-5,0,
,2021-04-09 05:00:00,40,17,23,Leicht bewölkt,-2,-5,0,
,2021-04-09 06:00:00,139,90,49,Leicht bewölkt,-2,-4,0,
,2021-04-09 07:00:00,335,207,128,Leicht bewölkt,0,-2,0,
,2021-04-09 08:00:00,487,307,180,Leicht bewölkt,2,1,0,
,2021-04-09 09:00:00,484,280,204,Leicht bewölkt,5,3,0,
,2021-04-09 10:00:00,531,308,223,Leicht bewölkt,6,5,0,
,2021-04-09 11:00:00,651,338,313,Leicht bewölkt,8,7,0,
,2021-04-09 12:00:00,667,299,368,Leicht bewölkt,10,9,0,
,2021-04-09 13:00:00,717,336,381,Leicht bewölkt,11,10,0,
,2021-04-09 14:00:00,747,388,359,Bedeckt,11,10,0,
,2021-04-09 15:00:00,799,374,425,Bedeckt,12,11,0,
,2021-04-09 16:00:00,772,360,412,Bedeckt,11,11,0,
,2021-04-09 17:00:00,764,378,386,Leicht bewölkt,10,10,0,
,2021-04-09 18:00:00,704,364,340,Leicht bewölkt,10,10,0,
,2021-04-09 19:00:00,517,259,258,Leicht bewölkt,9,9,0,
,2021-04-09 20:00:00,357,180,177,Leicht bewölkt,8,8,0,
,2021-04-09 21:00:00,153,64,89,Leicht bewölkt,7,7,0,
,2021-04-09 22:00:00,125,60,65,Leicht bewölkt,6,6,0,
,2021-04-09 23:00:00,93,46,47,Leicht bewölkt,5,4,0,
,2021-04-10 00:00:00,68,37,31,Leicht bewölkt,4,3,0,
,2021-04-10 01:00:00,58,24,34,Leicht bewölkt,3,2,0,
,2021-04-10 02:00:00,41,12,29,Leicht bewölkt,3,1,0,
,2021-04-10 03:00:00,21,9,12,Leicht bewölkt,2,0,0,
,2021-04-10 04:00:00,11,9,2,Leicht bewölkt,2,1,0,
,2021-04-10 05:00:00,30,15,15,Bedeckt,3,1,0,
,2021-04-10 06:00:00,47,28,19,Bedeckt,3,2,0,
,2021-04-10 07:00:00,90,63,27,Bedeckt,5,4,0,
,2021-04-10 08:00:00,176,111,65,Bedeckt,7,6,0,
,2021-04-10 09:00:00,337,161,176,Bedeckt,8,8,0,
,2021-04-10 10:00:00,454,243,211,Bedeckt,10,10,0,
,2021-04-10 11:00:00,561,291,270,Leicht bewölkt,12,12,0,
,2021-04-10 12:00:00,561,302,259,Leicht bewölkt,13,13,0,
,2021-04-10 13:00:00,749,392,357,Leicht bewölkt,14,14,0,
,2021-04-10 14:00:00,790,416,374,Leicht bewölkt,15,15,0,
,2021-04-10 15:00:00,792,402,390,Leicht bewölkt,15,15,0,
,2021-04-10 16:00:00,763,386,377,Leicht bewölkt,15,15,0,
,2021-04-10 17:00:00,745,375,370,Leicht bewölkt,15,15,0,
,2021-04-10 18:00:00,614,324,290,Leicht bewölkt,14,14,0,
,2021-04-10 19:00:00,400,208,192,Leicht bewölkt,14,14,0,
,2021-04-10 20:00:00,304,154,150,Bedeckt,13,13,0,
,2021-04-10 21:00:00,158,84,74,Bedeckt,12,12,0,
,2021-04-10 22:00:00,123,55,68,Bedeckt,10,10,0,
,2021-04-10 23:00:00,101,45,56,Leicht bewölkt,9,8,0,
,2021-04-11 00:00:00,87,47,40,Leicht bewölkt,7,6,0,
,2021-04-11 01:00:00,66,39,27,Leicht bewölkt,6,6,0,
,2021-04-11 02:00:00,30,14,16,Leicht bewölkt,6,5,0,
,2021-04-11 03:00:00,38,14,24,Leicht bewölkt,5,4,0,
,2021-04-11 04:00:00,15,8,7,Leicht bewölkt,6,5,0,
,2021-04-11 05:00:00,20,13,7,Bedeckt,6,6,0,
,2021-04-11 06:00:00,38,25,13,Bedeckt,7,7,0,
,2021-04-11 07:00:00,40,17,23,Bedeckt,9,9,0,
,2021-04-11 08:00:00,81,37,44,Leicht bewölkt,11,11,0,
,2021-04-11 09:00:00,199,110,89,Leicht bewölkt,12,13,0,
,2021-04-11 10:00:00,321,162,159,Leicht bewölkt,14,14,0,
,2021-04-11 11:00:00,453,230,223,Leicht bewölkt,15,16,0,
,2021-04-11 12:00:00,597,290,307,Leicht bewölkt,17,17,0,
,2021-04-11 13:00:00,673,333,340,Leicht bewölkt,18,18,0,
,2021-04-11 14:00:00,809,364,445,Leicht bewölkt,18,18,0,
,2021-04-11 15:00:00,844,463,381,Leicht bewölkt,19,19,0,
,2021-04-11 16:00:00,876,488,388,Leicht bewölkt,18,18,0,
,2021-04-11 17:00:00,975,541,434,Leicht bewölkt,18,18,0,
,2021-04-11 18:00:00,603,333,270,Leicht bewölkt,18,18,0,
,2021-04-11 19:00:00,342,182,160,Leicht bewölkt,17,17,0,
,2021-04-11 20:00:00,170,88,82,Leicht bewölkt,16,16,0,
,2021-04-11 21:00:00,97,53,44,Leicht bewölkt,16,16,0,
,2021-04-11 22:00:00,58,24,34,Leicht bewölkt,13,13,0,
,2021-04-11 23:00:00,43,27,16,Bedeckt,10,10,0,
,2021-04-12 00:00:00,26,13,13,Bedeckt,8,7,0,
,2021-04-12 01:00:00,11,6,5,Bedeckt,7,6,0,
,2021-04-12 02:00:00,6,4,2,Bewölkt,7,5,0,
,2021-04-12 03:00:00,2,0,2,Bewölkt,7,4,0,
,2021-04-12 04:00:00,4,4,0,Bewölkt,6,3,0,
,2021-04-12 05:00:00,34,19,15,Stellenweiser Regenfall,5,2,0.1,
,2021-04-12 06:00:00,107,70,37,Stellenweiser Regenfall,4,1,0.1,
,2021-04-12 07:00:00,390,267,123,Stellenweiser Regenfall,4,1,0,
,2021-04-12 08:00:00,447,252,195,Leichter Eisregen,3,1,0.8,
,2021-04-12 09:00:00,338,189,149,Leichter Eisregen,3,0,1.1,
,2021-04-12 10:00:00,159,69,90,Leichter Eisregen,3,0,0.5,
,2021-04-12 11:00:00,197,96,101,Starker Schneefall,3,1,0.9,
,2021-04-12 12:00:00,297,140,157,Starker Schneefall,3,1,1.2,
,2021-04-12 13:00:00,354,167,187,Starker Schneefall,3,1,0.6,
,2021-04-12 14:00:00,324,190,134,Starker Schneefall,3,1,0.8,
,2021-04-12 15:00:00,391,202,189,Starker Schneefall,3,1,1.1,
,2021-04-12 16:00:00,436,226,210,Starker Schneefall,3,1,0.5,
,2021-04-12 17:00:00,532,240,292,Starker Schneefall,3,0,0.8,
,2021-04-12 18:00:00,424,206,218,Starker Schneefall,2,0,1.1,
,2021-04-12 19:00:00,256,127,129,Starker Schneefall,2,0,0.6,
,2021-04-12 20:00:00,151,70,81,Stellenweise starker Schneefall,2,0,0.4,
,2021-04-12 21:00:00,93,50,43,Stellenweise starker Schneefall,1,1,0.5,
,2021-04-12 22:00:00,48,22,26,Stellenweise starker Schneefall,1,0,0.2,
,2021-04-12 23:00:00,24,14,10,Starker Schneefall,1,-1,0.4,
,2021-04-13 00:00:00,22,14,8,Starker Schneefall,1,-2,0.8,
,2021-04-13 01:00:00,10,6,4,Starker Schneefall,1,-2,0.4,
,2021-04-13 02:00:00,0,0,0,Starker Schneefall,0,-2,0.2,
,2021-04-13 03:00:00,5,2,3,Starker Schneefall,0,-2,0.3,
,2021-04-13 04:00:00,7,6,1,Starker Schneefall,0,-2,0.1,
,2021-04-13 05:00:00,38,20,18,Mäßiger Schneefall,0,-2,0.1,
,2021-04-13 06:00:00,156,86,70,Mäßiger Schneefall,1,-2,0.1,
,2021-04-13 07:00:00,571,342,229,Mäßiger Schneefall,1,-2,0.1,
,2021-04-13 08:00:00,701,421,280,Starker Schneefall,2,-1,0.1,
,2021-04-13 09:00:00,525,306,219,Starker Schneefall,2,-1,0.1,
,2021-04-13 10:00:00,425,233,192,Starker Schneefall,3,0,0.1,
,2021-04-13 11:00:00,521,259,262,Mäßige bis starke Schneefälle,3,0,0,
,2021-04-13 12:00:00,597,281,316,Mäßige bis starke Schneefälle,4,1,0,
,2021-04-13 13:00:00,517,241,276,Mäßige bis starke Schneefälle,4,1,0,
,2021-04-13 14:00:00,490,275,215,Bedeckt,5,2,0.3,
,2021-04-13 15:00:00,536,260,276,Bedeckt,5,2,0.4,
,2021-04-13 16:00:00,647,318,329,Bedeckt,4,1,0.2,
,2021-04-13 17:00:00,616,280,336,Leichter Regenschauer,3,0,0.4,
,2021-04-13 18:00:00,544,248,296,Leichter Regenschauer,2,-1,0.6,
,2021-04-13 19:00:00,378,196,182,Leichter Regenschauer,1,-2,0.3,
,2021-04-13 20:00:00,202,91,111,Mäßige bis starke Schneefälle,0,-2,0.2,
,2021-04-13 21:00:00,103,52,51,Mäßige bis starke Schneefälle,0,-3,0.3,
,2021-04-13 22:00:00,67,27,40,Mäßige bis starke Schneefälle,-1,-3,0.2,
,2021-04-13 23:00:00,92,45,47,Mäßige bis starke Schneefälle,-2,-4,0,
,2021-04-14 00:00:00,33,22,11,Mäßige bis starke Schneefälle,-2,-5,0.1,
,2021-04-14 01:00:00,21,14,7,Mäßige bis starke Schneefälle,-2,-5,0,
,2021-04-14 02:00:00,9,5,4,Mäßige bis starke Schneefälle,-3,-5,0,
,2021-04-14 03:00:00,8,8,0,Mäßige bis starke Schneefälle,-3,-6,0,
,2021-04-14 04:00:00,9,6,3,Mäßige bis starke Schneefälle,-2,-5,0,
,2021-04-14 05:00:00,36,17,19,Leichter Nebel,-2,-5,0,
,2021-04-14 06:00:00,145,77,68,Leichter Nebel,-1,-4,0,
,2021-04-14 07:00:00,572,334,238,Leichter Nebel,0,-3,0,
,2021-04-14 08:00:00,691,402,289,Stellenweise leichter Schneefall,1,-2,0,
,2021-04-14 09:00:00,543,308,235,Stellenweise leichter Schneefall,2,-1,0,
,2021-04-14 10:00:00,466,257,209,Stellenweise leichter Schneefall,4,0,0,
,2021-04-14 11:00:00,488,238,250,Stellenweise leichter Schneefall,5,2,0,
,2021-04-14 12:00:00,687,318,369,Stellenweise leichter Schneefall,6,3,0,
,2021-04-14 13:00:00,682,333,349,Stellenweise leichter Schneefall,6,3,0,
,2021-04-14 14:00:00,666,340,326,Leicht bewölkt,7,4,0,
,2021-04-14 15:00:00,698,352,346,Leicht bewölkt,7,4,0,
,2021-04-14 16:00:00,775,409,366,Leicht bewölkt,7,5,0,
,2021-04-14 17:00:00,839,423,416,Stellenweiser Regenfall,6,5,0,
,2021-04-14 18:00:00,652,302,350,Stellenweiser Regenfall,6,5,0,
,2021-04-14 19:00:00,415,202,213,Stellenweiser Regenfall,5,4,0,
,2021-04-14 20:00:00,243,128,115,Leicht bewölkt,4,3,0,
,2021-04-14 21:00:00,112,70,42,Leicht bewölkt,3,3,0,
,2021-04-14 22:00:00,77,33,44,Leicht bewölkt,2,1,0,
,2021-04-14 23:00:00,77,35,42,Leichte Eisregen,1,0,0.1,
,2021-04-15 00:00:00,28,13,15,Leichte Eisregen,0,-1,0.1,
,2021-04-15 01:00:00,20,13,7,Leichte Eisregen,-1,-2,0.1,
,2021-04-15 02:00:00,20,8,12,Mäßige bis starke Schneefälle,-2,-3,0,
,2021-04-15 03:00:00,8,2,6,Mäßige bis starke Schneefälle,-3,-4,0,
,2021-04-15 04:00:00,10,5,5,Mäßige bis starke Schneefälle,-2,-3,0,
,2021-04-15 05:00:00,53,30,23,Leicht bewölkt,-2,-2,0,
,2021-04-15 06:00:00,138,71,67,Leicht bewölkt,-1,-2,0,
,2021-04-15 07:00:00,602,377,225,Leicht bewölkt,0,-1,0,
,2021-04-15 08:00:00,688,388,300,Leicht bewölkt,2,0,0,
,2021-04-15 09:00:00,511,279,232,Leicht bewölkt,3,1,0,
,2021-04-15 10:00:00,419,234,185,Leicht bewölkt,4,2,0,
,2021-04-15 11:00:00,492,247,245,Stellenweiser Regenfall,5,3,0,
,2021-04-15 12:00:00,571,293,278,Stellenweiser Regenfall,6,4,0,
,2021-04-15 13:00:00,700,320,380,Stellenweiser Regenfall,7,5,0,
,2021-04-15 14:00:00,634,322,312,Bewölkt,7,5,0.1,
,2021-04-15 15:00:00,674,335,339,Bewölkt,8,5,0.1,
,2021-04-15 16:00:00,798,422,376,Bewölkt,7,5,0.1,
,2021-04-15 17:00:00,845,398,447,Leichter Regenschauer,7,5,0.1,
,2021-04-15 18:00:00,713,334,379,Leichter Regenschauer,7,6,0.2,
,2021-04-15 19:00:00,429,209,220,Leichter Regenschauer,6,5,0.1,
,2021-04-15 20:00:00,259,129,130,Leichter Regenschauer,5,5,0,
,2021-04-15 21:00:00,137,67,70,Leichter Regenschauer,5,5,0,
,2021-04-15 22:00:00,92,44,48,Leichter Regenschauer,3,1,0,
,2021-04-15 23:00:00,63,28,35,Leicht bewölkt,1,-2,0,
,2021-04-16 00:00:00,31,19,12,Leicht bewölkt,-1,-5,0,
,2021-04-16 01:00:00,26,9,17,Leicht bewölkt,-2,-5,0,
,2021-04-16 02:00:00,12,3,9,Leicht bewölkt,-2,-5,0,
,2021-04-16 03:00:00,1,1,0,Leicht bewölkt,-2,-5,0,
,2021-04-16 04:00:00,8,5,3,Leicht bewölkt,-2,-5,0,
,2021-04-16 05:00:00,37,14,23,Leicht bewölkt,-2,-4,0,
,2021-04-16 06:00:00,146,87,59,Leicht bewölkt,-1,-4,0,
,2021-04-16 07:00:00,580,359,221,Leicht bewölkt,0,-2,0,
,2021-04-16 08:00:00,624,354,270,Leicht bewölkt,2,-1,0,
,2021-04-16 09:00:00,600,353,247,Leicht bewölkt,3,1,0,
,2021-04-16 10:00:00,609,345,264,Leicht bewölkt,5,3,0,
,2021-04-16 11:00:00,637,322,315,Leicht bewölkt,6,4,0,
,2021-04-16 12:00:00,718,284,434,Leicht bewölkt,8,6,0,
,2021-04-16 13:00:00,790,361,429,Leicht bewölkt,9,6,0,
,2021-04-16 14:00:00,775,396,379,Leicht bewölkt,9,7,0,
,2021-04-16 15:00:00,829,443,386,Leicht bewölkt,10,7,0,
,2021-04-16 16:00:00,803,380,423,Leicht bewölkt,9,6,0,
,2021-04-16 17:00:00,726,340,386,Leicht bewölkt,8,5,0,
,2021-04-16 18:00:00,707,326,381,Leicht bewölkt,7,4,0,
,2021-04-16 19:00:00,539,262,277,Leicht bewölkt,6,2,0,
,2021-04-16 20:00:00,288,148,140,Leicht bewölkt,4,0,0,
,2021-04-16 21:00:00,167,87,80,Leicht bewölkt,3,-1,0,
,2021-04-16 22:00:00,113,57,56,Leicht bewölkt,2,-1,0,
,2021-04-16 23:00:00,102,53,49,Leicht bewölkt,1,-2,0,
,2021-04-17 00:00:00,80,36,44,Leicht bewölkt,0,-2,0,
,2021-04-17 01:00:00,52,21,31,Leicht bewölkt,-1,-3,0,
,2021-04-17 02:00:00,30,13,17,Leichter Nebel,-2,-4,0,
,2021-04-17 03:00:00,28,12,16,Leichter Nebel,-2,-5,0,
,2021-04-17 04:00:00,15,8,7,Leichter Nebel,-2,-4,0,
,2021-04-17 05:00:00,27,14,13,Leichter Nebel,-1,-3,0,
,2021-04-17 06:00:00,47,22,25,Leichter Nebel,0,-2,0,
,2021-04-17 07:00:00,74,33,41,Leichter Nebel,1,-1,0,
,2021-04-17 08:00:00,199,104,95,Leichter Schneefall,2,1,0,
,2021-04-17 09:00:00,317,174,143,Leichter Schneefall,4,2,0,
,2021-04-17 10:00:00,536,267,269,Leichter Schneefall,4,2,0,
,2021-04-17 11:00:00,559,287,272,Bedeckt,5,3,0,
,2021-04-17 12:00:00,664,367,297,Bedeckt,6,4,0,
,2021-04-17 13:00:00,563,325,238,Bedeckt,6,4,0,
,2021-04-17 14:00:00,558,276,282,Leichter Regenschauer,7,5,0,
,2021-04-17 15:00:00,576,301,275,Leichter Regenschauer,7,5,0,
,2021-04-17 16:00:00,508,264,244,Leichter Regenschauer,7,4,0,
,2021-04-17 17:00:00,474,244,230,Stellenweiser Regenfall,6,4,0,
,2021-04-17 18:00:00,413,218,195,Stellenweiser Regenfall,6,3,0,
,2021-04-17 19:00:00,327,148,179,Stellenweiser Regenfall,5,3,0,
,2021-04-17 20:00:00,318,167,151,Stellenweiser Regenfall,4,2,0,
,2021-04-17 21:00:00,125,60,65,Stellenweiser Regenfall,3,1,0,
,2021-04-17 22:00:00,73,30,43,Stellenweiser Regenfall,3,1,0,
,2021-04-17 23:00:00,31,12,19,Leicht bewölkt,3,1,0,
,2021-04-18 00:00:00,25,14,11,Leicht bewölkt,3,1,0,
,2021-04-18 01:00:00,17,8,9,Leicht bewölkt,3,1,0,
,2021-04-18 02:00:00,11,5,6,Bedeckt,3,2,0,
,2021-04-18 03:00:00,5,4,1,Bedeckt,3,2,0,
,2021-04-18 04:00:00,3,2,1,Bedeckt,3,2,0,
,2021-04-18 05:00:00,16,11,5,Bedeckt,3,2,0.1,
,2021-04-18 06:00:00,29,12,17,Bedeckt,3,2,0.1,
,2021-04-18 07:00:00,30,16,14,Bedeckt,3,2,0.1,
,2021-04-18 08:00:00,74,30,44,Leichter Eisregen,3,2,0.1,
,2021-04-18 09:00:00,152,81,71,Leichter Eisregen,4,2,0.2,
,2021-04-18 10:00:00,194,92,102,Leichter Eisregen,4,3,0.1,
,2021-04-18 11:00:00,247,145,102,Leichter Eisregen,5,3,0.2,
,2021-04-18 12:00:00,296,137,159,Leichter Eisregen,6,4,0.2,
,2021-04-18 13:00:00,321,169,152,Leichter Eisregen,6,5,0.1,
,2021-04-18 14:00:00,452,246,206,Nieselregen,7,5,0.1,
,2021-04-18 15:00:00,430,231,199,Nieselregen,8,6,0.2,
,2021-04-18 16:00:00,402,208,194,Nieselregen,7,6,0.1,
,2021-04-18 17:00:00,436,235,201,Leichter Regenschauer,7,6,0.1,
,2021-04-18 18:00:00,296,167,129,Leichter Regenschauer,7,5,0.2,
,2021-04-18 19:00:00,230,115,115,Leichter Regenschauer,6,5,0.1,
,2021-04-18 20:00:00,177,84,93,Leichter Regenschauer,5,4,0.1,
,2021-04-18 21:00:00,83,42,41,Leichter Regenschauer,4,3,0.1,
,2021-04-18 22:00:00,37,20,17,Leichter Regenschauer,4,3,0,
,2021-04-18 23:00:00,6,2,4,Leichter Regenschauer,4,4,0.2,
,2021-04-19 00:00:00,4,3,1,Leichter Regenschauer,4,4,0.3,
,2021-04-19 01:00:00,6,4,2,Leichter Regenschauer,4,4,0.2,
,2021-04-19 02:00:00,3,2,1,Nieselregen,4,4,0.1,
,2021-04-19 03:00:00,0,0,0,Nieselregen,4,4,0.1,
,2021-04-19 04:00:00,10,10,0,Nieselregen,4,4,0.1,
,2021-04-19 05:00:00,40,17,23,Leichter Nebel,4,4,0,
,2021-04-19 06:00:00,174,101,73,Leichter Nebel,4,4,0,
,2021-04-19 07:00:00,888,552,336,Leichter Nebel,5,5,0,
,2021-04-19 08:00:00,702,418,284,Leichter Nebel,5,5,0.1,
,2021-04-19 09:00:00,609,370,239,Leichter Nebel,5,5,0.1,
,2021-04-19 10:00:00,411,200,211,Leichter Nebel,6,5,0.1,
,2021-04-19 11:00:00,551,263,288,Nieselregen,6,6,0,
,2021-04-19 12:00:00,701,345,356,Nieselregen,7,6,0,
,2021-04-19 13:00:00,865,415,450,Nieselregen,7,7,0,
,2021-04-19 14:00:00,738,371,367,Bewölkt,8,7,0,
,2021-04-19 15:00:00,821,428,393,Bewölkt,9,8,0,
,2021-04-19 16:00:00,889,434,455,Bewölkt,8,8,0,
,2021-04-19 17:00:00,925,431,494,Bewölkt,8,7,0,
,2021-04-19 18:00:00,693,316,377,Bewölkt,7,7,0,
,2021-04-19 19:00:00,435,216,219,Bewölkt,6,6,0,
,2021-04-19 20:00:00,331,143,188,Leicht bewölkt,5,5,0,
,2021-04-19 21:00:00,103,52,51,Leicht bewölkt,4,4,0,
,2021-04-19 22:00:00,49,26,23,Leicht bewölkt,3,3,0,
,2021-04-19 23:00:00,22,6,16,Stellenweiser Regenfall,3,3,0,
,2021-04-20 00:00:00,9,4,5,Stellenweiser Regenfall,2,2,0.1,
,2021-04-20 01:00:00,2,1,1,Stellenweiser Regenfall,2,2,0,
,2021-04-20 02:00:00,4,3,1,Stellenweiser Regenfall,2,2,0,
,2021-04-20 03:00:00,1,0,1,Stellenweiser Regenfall,2,2,0,
,2021-04-20 04:00:00,8,8,0,Stellenweiser Regenfall,2,2,0,
,2021-04-20 05:00:00,46,29,17,Leicht bewölkt,3,3,0,
,2021-04-20 06:00:00,217,127,90,Leicht bewölkt,4,4,0,
,2021-04-20 07:00:00,868,516,352,Leicht bewölkt,5,4,0,
,2021-04-20 08:00:00,808,472,336,Bedeckt,5,5,0,
,2021-04-20 09:00:00,685,404,281,Bedeckt,6,6,0,
,2021-04-20 10:00:00,536,275,261,Bedeckt,8,7,0,
,2021-04-20 11:00:00,594,292,302,Leicht bewölkt,9,9,0,
,2021-04-20 12:00:00,799,374,425,Leicht bewölkt,10,10,0,
,2021-04-20 13:00:00,991,457,534,Leicht bewölkt,11,10,0,
,2021-04-20 14:00:00,808,376,432,Leicht bewölkt,11,11,0,
,2021-04-20 15:00:00,922,448,474,Leicht bewölkt,11,11,0,
,2021-04-20 16:00:00,985,504,481,Leicht bewölkt,10,10,0,
,2021-04-20 17:00:00,1089,532,557,Leicht bewölkt,9,8,0,
,2021-04-20 18:00:00,877,417,460,Leicht bewölkt,8,7,0,
,2021-04-20 19:00:00,543,258,285,Leicht bewölkt,7,6,0,
,2021-04-20 20:00:00,452,214,238,Leicht bewölkt,6,5,0,
,2021-04-20 21:00:00,176,76,100,Leicht bewölkt,4,4,0,
,2021-04-20 22:00:00,59,36,23,Leicht bewölkt,4,4,0,
,2021-04-20 23:00:00,20,6,14,Leicht bewölkt,4,4,0,
,2021-04-21 00:00:00,8,8,0,Leicht bewölkt,4,4,0,
,2021-04-21 01:00:00,3,3,0,Leicht bewölkt,3,3,0,
,2021-04-21 02:00:00,2,1,1,Leicht bewölkt,2,2,0,
,2021-04-21 03:00:00,5,2,3,Leicht bewölkt,2,2,0,
,2021-04-21 04:00:00,8,6,2,Leicht bewölkt,2,2,0,
,2021-04-21 05:00:00,46,29,17,Leicht bewölkt,3,3,0,
,2021-04-21 06:00:00,205,113,92,Leicht bewölkt,4,4,0,
,2021-04-21 07:00:00,925,588,337,Leicht bewölkt,6,6,0,
,2021-04-21 08:00:00,801,461,340,Leicht bewölkt,8,8,0,
,2021-04-21 09:00:00,663,370,293,Leicht bewölkt,10,10,0,
,2021-04-21 10:00:00,546,289,257,Leicht bewölkt,11,11,0,
,2021-04-21 11:00:00,637,329,308,Leicht bewölkt,13,13,0,
,2021-04-21 12:00:00,816,368,448,Leicht bewölkt,15,15,0,
,2021-04-21 13:00:00,931,433,498,Leicht bewölkt,15,15,0,
,2021-04-21 14:00:00,880,436,444,Leicht bewölkt,16,16,0,
,2021-04-21 15:00:00,957,493,464,Leicht bewölkt,16,16,0,
,2021-04-21 16:00:00,994,501,493,Leicht bewölkt,16,16,0,
,2021-04-21 17:00:00,1095,483,612,Leicht bewölkt,15,15,0,
,2021-04-21 18:00:00,892,426,466,Leicht bewölkt,15,15,0,
,2021-04-21 19:00:00,596,295,301,Leicht bewölkt,14,14,0,
,2021-04-21 20:00:00,438,204,234,Leicht bewölkt,13,13,0.1,
,2021-04-21 21:00:00,162,81,81,Leicht bewölkt,12,12,0.1,
,2021-04-21 22:00:00,60,33,27,Leicht bewölkt,10,10,0,
,2021-04-21 23:00:00,23,8,15,Leichter Regenschauer,8,8,0.4,
,2021-04-22 00:00:00,5,3,2,Leichter Regenschauer,7,7,0.9,
,2021-04-22 01:00:00,9,7,2,Leichter Regenschauer,6,6,0.4,
,2021-04-22 02:00:00,5,4,1,Leichter Regenschauer,6,6,0.3,
,2021-04-22 03:00:00,4,4,0,Leichter Regenschauer,6,6,0.4,
,2021-04-22 04:00:00,5,3,2,Leichter Regenschauer,7,7,0.2,
,2021-04-22 05:00:00,47,25,22,Nieselregen,7,7,0.1,
,2021-04-22 06:00:00,175,101,74,Nieselregen,7,7,0.1,
,2021-04-22 07:00:00,975,621,354,Nieselregen,8,7,0,
,2021-04-22 08:00:00,824,482,342,Leichter Nebel,8,7,0.2,
,2021-04-22 09:00:00,622,314,308,Leichter Nebel,8,7,0.2,
,2021-04-22 10:00:00,485,257,228,Leichter Nebel,8,7,0.1,
,2021-04-22 11:00:00,590,323,267,Leichter Regenfall,8,7,0.4,
,2021-04-22 12:00:00,787,387,400,Leichter Regenfall,8,6,0.5,
,2021-04-22 13:00:00,918,424,494,Leichter Regenfall,8,7,0.2,
,2021-04-22 14:00:00,822,379,443,Leichter Regenfall,8,7,0.3,
,2021-04-22 15:00:00,870,422,448,Leichter Regenfall,8,7,0.4,
,2021-04-22 16:00:00,975,494,481,Leichter Regenfall,8,7,0.2,
,2021-04-22 17:00:00,937,442,495,Leichter Regenfall,8,7,0.3,
,2021-04-22 18:00:00,787,345,442,Leichter Regenfall,7,7,0.4,
,2021-04-22 19:00:00,460,233,227,Leichter Regenfall,6,6,0.2,
,2021-04-22 20:00:00,342,145,197,Stellenweiser leichter Regenfall,6,5,0.2,
,2021-04-22 21:00:00,163,76,87,Stellenweiser leichter Regenfall,5,4,0.2,
,2021-04-22 22:00:00,42,27,15,Stellenweiser leichter Regenfall,4,2,0.1,
,2021-04-22 23:00:00,19,8,11,Leicht bewölkt,3,1,0,
,2021-04-23 00:00:00,10,5,5,Leicht bewölkt,2,-1,0,
,2021-04-23 01:00:00,2,2,0,Leicht bewölkt,1,-1,0,
,2021-04-23 02:00:00,7,4,3,Leicht bewölkt,1,-2,0,
,2021-04-23 03:00:00,2,2,0,Leicht bewölkt,0,-2,0,
,2021-04-23 04:00:00,4,3,1,Leicht bewölkt,1,-1,0,
,2021-04-23 05:00:00,34,19,15,Leicht bewölkt,2,0,0,
,2021-04-23 06:00:00,189,112,77,Leicht bewölkt,3,2,0,
,2021-04-23 07:00:00,875,558,317,Leicht bewölkt,5,3,0,
,2021-04-23 08:00:00,812,495,317,Leicht bewölkt,6,5,0,
,2021-04-23 09:00:00,745,443,302,Leicht bewölkt,8,7,0,
,2021-04-23 10:00:00,637,339,298,Leicht bewölkt,9,8,0,
,2021-04-23 11:00:00,758,372,386,Sonnig,11,9,0,
,2021-04-23 12:00:00,924,429,495,Sonnig,12,10,0,
,2021-04-23 13:00:00,1106,441,665,Sonnig,12,11,0,
,2021-04-23 14:00:00,1040,505,535,Leicht bewölkt,13,11,0,
,2021-04-23 15:00:00,1009,510,499,Leicht bewölkt,13,11,0,
,2021-04-23 16:00:00,973,522,451,Leicht bewölkt,12,11,0,
,2021-04-23 17:00:00,1046,520,526,Leicht bewölkt,11,10,0,
,2021-04-23 18:00:00,875,439,436,Leicht bewölkt,10,10,0,
,2021-04-23 19:00:00,656,336,320,Leicht bewölkt,9,9,0,
,2021-04-23 20:00:00,512,245,267,Sonnig,8,8,0,
,2021-04-23 21:00:00,218,95,123,Sonnig,7,7,0,
,2021-04-23 22:00:00,89,29,60,Sonnig,6,6,0,
,2021-04-23 23:00:00,37,16,21,Sonnig,6,5,0,
,2021-04-24 00:00:00,22,10,12,Sonnig,5,5,0,
,2021-04-24 01:00:00,23,15,8,Sonnig,4,3,0,
,2021-04-24 02:00:00,7,1,6,Sonnig,3,2,0,
,2021-04-24 03:00:00,1,0,1,Sonnig,2,1,0,
,2021-04-24 04:00:00,6,2,4,Sonnig,3,2,0,
,2021-04-24 05:00:00,31,11,20,Sonnig,3,2,0,
,2021-04-24 06:00:00,65,38,27,Sonnig,4,3,0,
,2021-04-24 07:00:00,107,60,47,Sonnig,6,5,0,
,2021-04-24 08:00:00,279,155,124,Leicht bewölkt,8,7,0,
,2021-04-24 09:00:00,467,253,214,Leicht bewölkt,10,9,0,
,2021-04-24 10:00:00,743,381,362,Leicht bewölkt,11,11,0,
,2021-04-24 11:00:00,769,395,374,Leicht bewölkt,13,13,0,
,2021-04-24 12:00:00,896,495,401,Leicht bewölkt,15,15,0,
,2021-04-24 13:00:00,958,511,447,Leicht bewölkt,16,16,0,
,2021-04-24 14:00:00,1024,511,513,Sonnig,16,16,0,
,2021-04-24 15:00:00,994,503,491,Sonnig,16,16,0,
,2021-04-24 16:00:00,927,492,435,Sonnig,16,16,0,
,2021-04-24 17:00:00,895,450,445,Leicht bewölkt,15,15,0,
,2021-04-24 18:00:00,917,497,420,Leicht bewölkt,15,15,0,
,2021-04-24 19:00:00,571,311,260,Leicht bewölkt,14,14,0,
,2021-04-24 20:00:00,394,186,208,Leicht bewölkt,13,13,0,
,2021-04-24 21:00:00,280,110,170,Leicht bewölkt,12,12,0,
,2021-04-24 22:00:00,128,63,65,Leicht bewölkt,10,10,0,
,2021-04-24 23:00:00,46,24,22,Leicht bewölkt,9,8,0,
,2021-04-25 00:00:00,29,14,15,Leicht bewölkt,7,6,0,
,2021-04-25 01:00:00,10,6,4,Leicht bewölkt,6,5,0,
,2021-04-25 02:00:00,4,3,1,Leicht bewölkt,5,4,0,
,2021-04-25 03:00:00,0,0,0,Leicht bewölkt,4,2,0,
,2021-04-25 04:00:00,3,3,0,Leicht bewölkt,4,3,0,
,2021-04-25 05:00:00,16,6,10,Leicht bewölkt,5,4,0,
,2021-04-25 06:00:00,46,25,21,Leicht bewölkt,6,5,0,
,2021-04-25 07:00:00,65,26,39,Leicht bewölkt,7,6,0,
,2021-04-25 08:00:00,126,48,78,Leicht bewölkt,9,8,0,
,2021-04-25 09:00:00,256,135,121,Leicht bewölkt,11,10,0,
,2021-04-25 10:00:00,472,229,243,Leicht bewölkt,12,11,0,
,2021-04-25 11:00:00,605,329,276,Leicht bewölkt,13,13,0,
,2021-04-25 12:00:00,811,411,400,Leicht bewölkt,15,14,0,
,2021-04-25 13:00:00,867,432,435,Leicht bewölkt,15,15,0,
,2021-04-25 14:00:00,974,524,450,Leicht bewölkt,16,16,0,
,2021-04-25 15:00:00,892,472,420,Leicht bewölkt,16,16,0,
,2021-04-25 16:00:00,912,473,439,Leicht bewölkt,16,16,0,
,2021-04-25 17:00:00,780,395,385,Leicht bewölkt,15,15,0,
,2021-04-25 18:00:00,863,480,383,Leicht bewölkt,14,14,0,
,2021-04-25 19:00:00,531,284,247,Leicht bewölkt,14,14,0,
,2021-04-25 20:00:00,347,182,165,Leicht bewölkt,13,13,0,
,2021-04-25 21:00:00,194,87,107,Leicht bewölkt,12,12,0,
,2021-04-25 22:00:00,53,23,30,Leicht bewölkt,10,10,0,
,2021-04-25 23:00:00,15,10,5,Leicht bewölkt,8,7,0,
,2021-04-26 00:00:00,6,3,3,Leicht bewölkt,6,5,0,
,2021-04-26 01:00:00,7,6,1,Leicht bewölkt,5,3,0,
,2021-04-26 02:00:00,3,2,1,Leicht bewölkt,3,2,0,
,2021-04-26 03:00:00,2,2,0,Leicht bewölkt,2,0,0,
,2021-04-26 04:00:00,8,6,2,Leicht bewölkt,2,0,0,
,2021-04-26 05:00:00,46,20,26,Leicht bewölkt,3,1,0,
,2021-04-26 06:00:00,214,126,88,Leicht bewölkt,3,1,0,
,2021-04-26 07:00:00,934,608,326,Leicht bewölkt,5,3,0,
,2021-04-26 08:00:00,826,474,352,Bedeckt,7,5,0,
,2021-04-26 09:00:00,650,356,294,Bedeckt,8,7,0,
,2021-04-26 10:00:00,457,241,216,Bedeckt,10,9,0,
,2021-04-26 11:00:00,548,316,232,Leicht bewölkt,11,10,0,
,2021-04-26 12:00:00,820,393,427,Leicht bewölkt,13,12,0,
,2021-04-26 13:00:00,946,402,544,Leicht bewölkt,13,12,0,
,2021-04-26 14:00:00,718,344,374,Leicht bewölkt,14,13,0,
,2021-04-26 15:00:00,919,469,450,Leicht bewölkt,15,14,0,
,2021-04-26 16:00:00,992,517,475,Leicht bewölkt,14,13,0,
,2021-04-26 17:00:00,1055,472,583,Leicht bewölkt,13,12,0,
,2021-04-26 18:00:00,883,422,461,Leicht bewölkt,12,12,0,
,2021-04-26 19:00:00,574,272,302,Leicht bewölkt,11,10,0,
,2021-04-26 20:00:00,392,178,214,Leicht bewölkt,10,8,0,
,2021-04-26 21:00:00,221,83,138,Leicht bewölkt,9,6,0,
,2021-04-26 22:00:00,74,47,27,Leicht bewölkt,8,6,0,
,2021-04-26 23:00:00,18,10,8,Leicht bewölkt,7,5,0,
,2021-04-27 00:00:00,9,3,6,Leicht bewölkt,6,4,0,
,2021-04-27 01:00:00,3,3,0,Leicht bewölkt,5,2,0,
,2021-04-27 02:00:00,5,1,4,Leicht bewölkt,4,1,0,
,2021-04-27 03:00:00,3,3,0,Leicht bewölkt,2,0,0,
,2021-04-27 04:00:00,9,6,3,Leicht bewölkt,3,0,0,
,2021-04-27 05:00:00,63,31,32,Leicht bewölkt,3,1,0,
,2021-04-27 06:00:00,208,109,99,Leicht bewölkt,3,2,0,
,2021-04-27 07:00:00,968,624,344,Leicht bewölkt,4,3,0,
,2021-04-27 08:00:00,879,516,363,Bewölkt,5,4,0,
,2021-04-27 09:00:00,736,418,318,Bewölkt,6,6,0,
,2021-04-27 10:00:00,587,309,278,Bewölkt,6,6,0,
,2021-04-27 11:00:00,702,381,321,Stellenweiser Regenfall,7,7,0.2,
,2021-04-27 12:00:00,801,322,479,Stellenweiser Regenfall,7,7,0.2,
,2021-04-27 13:00:00,1056,459,597,Stellenweiser Regenfall,7,7,0.1,
,2021-04-27 14:00:00,880,432,448,Nieselregen,8,8,0.2,
,2021-04-27 15:00:00,1018,532,486,Nieselregen,8,8,0.3,
,2021-04-27 16:00:00,1073,545,528,Nieselregen,8,8,0.1,
,2021-04-27 17:00:00,1172,594,578,Nieselregen,7,7,0.4,
,2021-04-27 18:00:00,976,455,521,Nieselregen,7,7,0.5,
,2021-04-27 19:00:00,691,321,370,Nieselregen,6,6,0.2,
,2021-04-27 20:00:00,475,215,260,Leichter Regenfall,5,5,0.8,
,2021-04-27 21:00:00,284,121,163,Leichter Regenfall,4,4,1,
,2021-04-27 22:00:00,91,46,45,Leichter Regenfall,5,5,0.5,
,2021-04-27 23:00:00,44,22,22,Bewölkt,5,5,0,
,2021-04-28 00:00:00,21,7,14,Bewölkt,5,5,0,
,2021-04-28 01:00:00,3,2,1,Bewölkt,5,5,0,
,2021-04-28 02:00:00,3,0,3,Bedeckt,6,5,0,
,2021-04-28 03:00:00,6,4,2,Bedeckt,6,6,0,
,2021-04-28 04:00:00,5,4,1,Bedeckt,6,6,0,
,2021-04-28 05:00:00,47,27,20,Stellenweiser Nieselregen,7,7,0.3,
,2021-04-28 06:00:00,202,102,100,Stellenweiser Nieselregen,7,7,0.4,
,2021-04-28 07:00:00,864,539,325,Stellenweiser Nieselregen,9,9,0.2,
,2021-04-28 08:00:00,816,463,353,Stellenweiser leichter Regenfall,10,10,0.2,
,2021-04-28 09:00:00,659,360,299,Stellenweiser leichter Regenfall,11,12,0.2,
,2021-04-28 10:00:00,479,253,226,Stellenweiser leichter Regenfall,13,13,0.1,
,2021-04-28 11:00:00,467,247,220,Stellenweiser Regenfall,14,14,0.2,
,2021-04-28 12:00:00,653,322,331,Stellenweiser Regenfall,15,15,0.2,
,2021-04-28 13:00:00,900,423,477,Stellenweiser Regenfall,15,15,0.1,
,2021-04-28 14:00:00,706,352,354,Stellenweiser Regenfall,16,16,0.1,
,2021-04-28 15:00:00,848,411,437,Stellenweiser Regenfall,16,16,0.2,
,2021-04-28 16:00:00,947,495,452,Stellenweiser Regenfall,15,15,0.1,
,2021-04-28 17:00:00,1098,524,574,Leichter Regenschauer,14,14,0.1,
,2021-04-28 18:00:00,820,388,432,Leichter Regenschauer,14,14,0.2,
,2021-04-28 19:00:00,494,241,253,Leichter Regenschauer,13,12,0.1,
,2021-04-28 20:00:00,337,148,189,Leichter Regenschauer,11,11,0.5,
,2021-04-28 21:00:00,208,97,111,Leichter Regenschauer,10,9,0.6,
,2021-04-28 22:00:00,71,42,29,Leichter Regenschauer,10,9,0.3,
,2021-04-28 23:00:00,56,26,30,Leichter Regenfall,10,9,0.8,
,2021-04-29 00:00:00,11,7,4,Leichter Regenfall,10,8,1.5,
,2021-04-29 01:00:00,2,1,1,Leichter Regenfall,10,8,0.8,
,2021-04-29 02:00:00,4,3,1,Leichter Regenfall,9,8,0.4,
,2021-04-29 03:00:00,3,2,1,Leichter Regenfall,9,8,0.5,
,2021-04-29 04:00:00,5,5,0,Leichter Regenfall,9,8,0.2,
,2021-04-29 05:00:00,38,24,14,Nieselregen,9,8,0.1,
,2021-04-29 06:00:00,153,76,77,Nieselregen,9,8,0.1,
,2021-04-29 07:00:00,743,467,276,Nieselregen,9,8,0.1,
,2021-04-29 08:00:00,696,404,292,Leichter Nebel,9,8,0.3,
,2021-04-29 09:00:00,530,305,225,Leichter Nebel,9,8,0.4,
,2021-04-29 10:00:00,367,191,176,Leichter Nebel,10,9,0.2,
,2021-04-29 11:00:00,472,253,219,Leichter Regenfall,11,10,0.5,
,2021-04-29 12:00:00,590,253,337,Leichter Regenfall,11,11,0.7,
,2021-04-29 13:00:00,742,338,404,Leichter Regenfall,11,11,0.3,
,2021-04-29 14:00:00,606,320,286,Leichter Regenfall,11,10,0.2,
,2021-04-29 15:00:00,716,367,349,Leichter Regenfall,12,10,0.3,
,2021-04-29 16:00:00,780,409,371,Leichter Regenfall,11,10,0.2,
,2021-04-29 17:00:00,840,425,415,Stellenweiser Regenfall,11,9,0.1,
,2021-04-29 18:00:00,677,290,387,Stellenweiser Regenfall,10,9,0.1,
,2021-04-29 19:00:00,424,192,232,Stellenweiser Regenfall,9,8,0.1,
,2021-04-29 20:00:00,243,120,123,Leichter Regenschauer,9,8,0,
,2021-04-29 21:00:00,170,90,80,Leichter Regenschauer,8,7,0,
,2021-04-29 22:00:00,97,53,44,Leichter Regenschauer,7,7,0,
,2021-04-29 23:00:00,45,24,21,Stellenweiser Regenfall,6,6,0,
,2021-04-30 00:00:00,17,9,8,Stellenweiser Regenfall,5,5,0,
,2021-04-30 01:00:00,4,4,0,Stellenweiser Regenfall,5,5,0,
,2021-04-30 02:00:00,5,2,3,Leicht bewölkt,5,5,0,
,2021-04-30 03:00:00,5,5,0,Leicht bewölkt,5,5,0,
,2021-04-30 04:00:00,3,3,0,Leicht bewölkt,6,5,0,
,2021-04-30 05:00:00,26,12,14,Leicht bewölkt,6,6,0,
,2021-04-30 06:00:00,160,101,59,Leicht bewölkt,7,7,0,
,2021-04-30 07:00:00,613,396,217,Leicht bewölkt,9,8,0,
,2021-04-30 08:00:00,774,436,338,Leicht bewölkt,10,10,0,
,2021-04-30 09:00:00,735,443,292,Leicht bewölkt,12,11,0,
,2021-04-30 10:00:00,727,422,305,Leicht bewölkt,13,12,0,
,2021-04-30 11:00:00,803,410,393,Leicht bewölkt,14,14,0,
,2021-04-30 12:00:00,819,337,482,Leicht bewölkt,15,15,0,
,2021-04-30 13:00:00,890,391,499,Leicht bewölkt,15,14,0,
,2021-04-30 14:00:00,938,493,445,Leicht bewölkt,14,13,0.1,
,2021-04-30 15:00:00,843,420,423,Leicht bewölkt,13,13,0.1,
,2021-04-30 16:00:00,642,315,327,Leicht bewölkt,12,11,0.1,
,2021-04-30 17:00:00,565,263,302,Nieselregen,11,10,0.4,
,2021-04-30 18:00:00,503,256,247,Nieselregen,10,9,0.5,
,2021-04-30 19:00:00,326,158,168,Nieselregen,10,9,0.2,
,2021-04-30 20:00:00,222,105,117,Leichter Regenfall,9,9,0.4,
,2021-04-30 21:00:00,159,69,90,Leichter Regenfall,9,9,0.5,
,2021-04-30 22:00:00,66,37,29,Leichter Regenfall,8,8,0.3,
,2021-04-30 23:00:00,54,30,24,Nieselregen,7,7,0,
,2021-05-01 00:00:00,25,14,11,Nieselregen,6,6,0.1,
,2021-05-01 01:00:00,16,6,10,Nieselregen,6,6,0,
,2021-05-01 02:00:00,7,6,1,Leichter Nebel,6,6,0,
,2021-05-01 03:00:00,10,4,6,Leichter Nebel,6,6,0,
,2021-05-01 04:00:00,2,1,1,Leichter Nebel,7,6,0,
,2021-05-01 05:00:00,23,14,9,Leichter Nebel,7,7,0,
,2021-05-01 06:00:00,34,17,17,Leichter Nebel,8,7,0,
,2021-05-01 07:00:00,48,30,18,Leichter Nebel,9,9,0,
,2021-05-01 08:00:00,89,51,38,Leicht bewölkt,11,10,0,
,2021-05-01 09:00:00,188,123,65,Leicht bewölkt,12,12,0,
,2021-05-01 10:00:00,281,131,150,Leicht bewölkt,13,13,0,
,2021-05-01 11:00:00,278,147,131,Leicht bewölkt,15,15,0,
,2021-05-01 12:00:00,326,158,168,Leicht bewölkt,16,16,0,
,2021-05-01 13:00:00,384,191,193,Leicht bewölkt,17,17,0,
,2021-05-01 14:00:00,326,151,175,Leicht bewölkt,17,17,0.1,
,2021-05-01 15:00:00,308,178,130,Leicht bewölkt,18,18,0.1,
,2021-05-01 16:00:00,216,107,109,Leicht bewölkt,17,16,0,
,2021-05-01 17:00:00,166,73,93,Leichter Regenschauer,16,15,0.2,
,2021-05-01 18:00:00,157,88,69,Leichter Regenschauer,15,14,0.2,
,2021-05-01 19:00:00,147,78,69,Leichter Regenschauer,14,13,0.1,
,2021-05-01 20:00:00,93,38,55,Leichter Regenschauer,13,12,0.2,
,2021-05-01 21:00:00,120,56,64,Leichter Regenschauer,12,11,0.2,
,2021-05-01 22:00:00,84,38,46,Leichter Regenschauer,11,9,0.1,
,2021-05-01 23:00:00,40,16,24,Mäßiger Regenfall,9,7,1.3,
,2021-05-02 00:00:00,12,4,8,Mäßiger Regenfall,8,6,2.5,
,2021-05-02 01:00:00,7,2,5,Mäßiger Regenfall,8,5,1.3,
,2021-05-02 02:00:00,5,1,4,Mäßiger Regenfall,7,5,2.4,
,2021-05-02 03:00:00,1,1,0,Mäßiger Regenfall,7,5,3.2,
,2021-05-02 04:00:00,5,3,2,Mäßiger Regenfall,6,5,1.6,
,2021-05-02 05:00:00,21,15,6,Starker Regenfall,6,4,1,
,2021-05-02 06:00:00,22,14,8,Starker Regenfall,6,4,1.4,
,2021-05-02 07:00:00,22,9,13,Starker Regenfall,6,4,0.7,
,2021-05-02 08:00:00,35,14,21,Leichter Nebel,6,4,0.5,
,2021-05-02 09:00:00,70,49,21,Leichter Nebel,6,4,0.6,
,2021-05-02 10:00:00,102,62,40,Leichter Nebel,6,4,0.3,
,2021-05-02 11:00:00,173,92,81,Leichter Regenfall,6,4,1,
,2021-05-02 12:00:00,243,102,141,Leichter Regenfall,6,5,1.3,
,2021-05-02 13:00:00,314,149,165,Leichter Regenfall,6,5,0.7,
,2021-05-02 14:00:00,364,190,174,Mäßiger Regenfall,6,5,0.9,
,2021-05-02 15:00:00,441,246,195,Mäßiger Regenfall,6,5,1.2,
,2021-05-02 16:00:00,298,137,161,Mäßiger Regenfall,5,5,0.6,
,2021-05-02 17:00:00,258,129,129,Leichter Regenfall,5,4,1.1,
,2021-05-02 18:00:00,209,104,105,Leichter Regenfall,5,4,1.4,
,2021-05-02 19:00:00,188,105,83,Leichter Regenfall,4,3,0.7,
,2021-05-02 20:00:00,137,75,62,Mäßiger Regenfall,4,3,0.5,
,2021-05-02 21:00:00,98,55,43,Mäßiger Regenfall,4,2,0.7,
,2021-05-02 22:00:00,33,17,16,Mäßiger Regenfall,4,3,0.3,
,2021-05-02 23:00:00,20,11,9,Nieselregen,4,3,0.1,
,2021-05-03 00:00:00,5,3,2,Nieselregen,5,4,0.1,
,2021-05-03 01:00:00,1,1,0,Nieselregen,5,4,0.1,
,2021-05-03 02:00:00,1,0,1,Nebel,5,4,0.1,
,2021-05-03 03:00:00,0,0,0,Nebel,5,4,0.1,
,2021-05-03 04:00:00,7,5,2,Nebel,5,4,0.1,
,2021-05-03 05:00:00,41,23,18,Nieselregen,5,5,0,
,2021-05-03 06:00:00,190,112,78,Nieselregen,5,5,0,
,2021-05-03 07:00:00,583,346,237,Nieselregen,6,6,0,
,2021-05-03 08:00:00,745,425,320,Bewölkt,7,7,0,
,2021-05-03 09:00:00,588,329,259,Bewölkt,8,8,0,
,2021-05-03 10:00:00,451,254,197,Bewölkt,9,9,0,
,2021-05-03 11:00:00,551,294,257,Leichter Regenschauer,10,10,0,
,2021-05-03 12:00:00,733,340,393,Leichter Regenschauer,11,11,0,
,2021-05-03 13:00:00,759,373,386,Leichter Regenschauer,11,12,0,
,2021-05-03 14:00:00,788,420,368,Leicht bewölkt,12,12,0,
,2021-05-03 15:00:00,872,424,448,Leicht bewölkt,13,13,0,
,2021-05-03 16:00:00,1001,530,471,Leicht bewölkt,12,12,0,
,2021-05-03 17:00:00,1039,451,588,Leicht bewölkt,12,12,0,
,2021-05-03 18:00:00,899,431,468,Leicht bewölkt,12,12,0,
,2021-05-03 19:00:00,561,257,304,Leicht bewölkt,11,11,0,
,2021-05-03 20:00:00,402,178,224,Leicht bewölkt,10,10,0,
,2021-05-03 21:00:00,189,94,95,Leicht bewölkt,9,9,0,
,2021-05-03 22:00:00,77,39,38,Leicht bewölkt,8,7,0,
,2021-05-03 23:00:00,35,18,17,Leicht bewölkt,6,5,0,
,2021-05-04 00:00:00,16,9,7,Leicht bewölkt,4,3,0,
,2021-05-04 01:00:00,5,3,2,Leicht bewölkt,4,2,0,
,2021-05-04 02:00:00,2,2,0,Leicht bewölkt,3,1,0,
,2021-05-04 03:00:00,6,2,4,Leicht bewölkt,2,0,0,
,2021-05-04 04:00:00,6,4,2,Leicht bewölkt,3,1,0,
,2021-05-04 05:00:00,55,33,22,Leicht bewölkt,4,2,0,
,2021-05-04 06:00:00,219,134,85,Leicht bewölkt,5,4,0,
,2021-05-04 07:00:00,613,359,254,Leicht bewölkt,7,6,0,
,2021-05-04 08:00:00,779,478,301,Leicht bewölkt,9,8,0,
,2021-05-04 09:00:00,631,390,241,Leicht bewölkt,11,10,0,
,2021-05-04 10:00:00,512,260,252,Leicht bewölkt,13,11,0,
,2021-05-04 11:00:00,560,294,266,Leicht bewölkt,14,13,0,
,2021-05-04 12:00:00,682,289,393,Leicht bewölkt,15,15,0,
,2021-05-04 13:00:00,700,332,368,Leicht bewölkt,15,14,0,
,2021-05-04 14:00:00,664,335,329,Bedeckt,14,13,0,
,2021-05-04 15:00:00,672,336,336,Bedeckt,14,13,0,
,2021-05-04 16:00:00,793,395,398,Bedeckt,13,11,0,
,2021-05-04 17:00:00,871,379,492,Bedeckt,12,9,0,
,2021-05-04 18:00:00,716,290,426,Bedeckt,10,8,0,
,2021-05-04 19:00:00,454,204,250,Bedeckt,10,7,0,
,2021-05-04 20:00:00,235,109,126,Bewölkt,9,7,0.3,
,2021-05-04 21:00:00,185,85,100,Bewölkt,9,7,0.4,
,2021-05-04 22:00:00,71,47,24,Bewölkt,9,6,0.2,
,2021-05-04 23:00:00,50,23,27,Mäßiger Regenfall,9,6,1.5,
,2021-05-05 00:00:00,14,7,7,Mäßiger Regenfall,8,6,2.9,
,2021-05-05 01:00:00,8,7,1,Mäßiger Regenfall,8,6,1.5,
,2021-05-05 02:00:00,0,0,0,Mäßiger Regenfall,8,6,0.8,
,2021-05-05 03:00:00,3,3,0,Mäßiger Regenfall,8,6,1.1,
,2021-05-05 04:00:00,4,3,1,Mäßiger Regenfall,8,6,0.5,
,2021-05-05 05:00:00,35,21,14,Stellenweiser leichter Regenfall,8,6,0.1,
,2021-05-05 06:00:00,125,74,51,Stellenweiser leichter Regenfall,8,7,0.2,
,2021-05-05 07:00:00,420,263,157,Stellenweiser leichter Regenfall,8,6,0.1,
,2021-05-05 08:00:00,552,313,239,Bedeckt,8,6,1,
,2021-05-05 09:00:00,505,315,190,Bedeckt,8,6,1.3,
,2021-05-05 10:00:00,398,203,195,Bedeckt,8,6,0.6,
,2021-05-05 11:00:00,408,222,186,Mäßiger Regenfall,8,5,1.3,
,2021-05-05 12:00:00,486,215,271,Mäßiger Regenfall,8,5,1.7,
,2021-05-05 13:00:00,562,302,260,Mäßiger Regenfall,8,5,0.8,
,2021-05-05 14:00:00,556,284,272,Mäßiger Regenfall,8,5,0.7,
,2021-05-05 15:00:00,615,307,308,Mäßiger Regenfall,9,6,1,
,2021-05-05 16:00:00,759,356,403,Mäßiger Regenfall,8,6,0.5,
,2021-05-05 17:00:00,724,319,405,Stellenweiser Regenfall,8,6,0.4,
,2021-05-05 18:00:00,658,310,348,Stellenweiser Regenfall,8,6,0.6,
,2021-05-05 19:00:00,432,205,227,Stellenweiser Regenfall,7,5,0.3,
,2021-05-05 20:00:00,266,137,129,Leichter Regenfall,7,5,0.4,
,2021-05-05 21:00:00,174,77,97,Leichter Regenfall,6,5,0.5,
,2021-05-05 22:00:00,63,40,23,Leichter Regenfall,6,4,0.2,
,2021-05-05 23:00:00,57,28,29,Nieselregen,5,3,0.2,
,2021-05-06 00:00:00,11,7,4,Nieselregen,5,2,0.3,
,2021-05-06 01:00:00,9,7,2,Nieselregen,4,3,0.2,
,2021-05-06 02:00:00,3,1,2,Nieselregen,4,3,0.1,
,2021-05-06 03:00:00,1,1,0,Nieselregen,4,3,0.1,
,2021-05-06 04:00:00,4,3,1,Nieselregen,5,4,0,
,2021-05-06 05:00:00,38,16,22,Leicht bewölkt,6,4,0,
,2021-05-06 06:00:00,161,100,61,Leicht bewölkt,6,5,0,
,2021-05-06 07:00:00,519,314,205,Leicht bewölkt,7,5,0,
,2021-05-06 08:00:00,679,395,284,Stellenweiser Regenfall,8,6,0,
,2021-05-06 09:00:00,550,315,235,Stellenweiser Regenfall,9,7,0,
,2021-05-06 10:00:00,492,277,215,Stellenweiser Regenfall,9,7,0,
,2021-05-06 11:00:00,509,249,260,Stellenweiser Regenfall,9,8,0,
,2021-05-06 12:00:00,467,207,260,Stellenweiser Regenfall,10,8,0,
,2021-05-06 13:00:00,465,215,250,Stellenweiser Regenfall,10,9,0,
,2021-05-06 14:00:00,349,167,182,Bedeckt,10,9,0.1,
,2021-05-06 15:00:00,359,194,165,Bedeckt,11,10,0.1,
,2021-05-06 16:00:00,438,228,210,Bedeckt,10,9,0,
,2021-05-06 17:00:00,412,190,222,Nieselregen,10,9,0.6,
,2021-05-06 18:00:00,332,147,185,Nieselregen,9,9,0.8,
,2021-05-06 19:00:00,232,105,127,Nieselregen,8,8,0.4,
,2021-05-06 20:00:00,164,80,84,Leichter Regenfall,7,7,1.1,
,2021-05-06 21:00:00,95,41,54,Leichter Regenfall,6,6,1.5,
,2021-05-06 22:00:00,51,29,22,Leichter Regenfall,6,5,0.8,
,2021-05-06 23:00:00,44,29,15,Mäßiger Regenfall,6,5,0.3,
,2021-05-07 00:00:00,20,11,9,Mäßiger Regenfall,7,4,0.6,
,2021-05-07 01:00:00,8,3,5,Mäßiger Regenfall,7,4,0.3,
,2021-05-07 02:00:00,4,2,2,Bedeckt,7,4,0.6,
,2021-05-07 03:00:00,3,2,1,Bedeckt,8,4,0.8,
,2021-05-07 04:00:00,4,3,1,Bedeckt,8,4,0.4,
,2021-05-07 05:00:00,30,16,14,Mäßiger Regenfall,8,4,0.9,
,2021-05-07 06:00:00,140,87,53,Mäßiger Regenfall,8,5,1.2,
,2021-05-07 07:00:00,477,297,180,Mäßiger Regenfall,8,5,0.6,
,2021-05-07 08:00:00,647,419,228,Mäßiger Regenfall,8,5,0.7,
,2021-05-07 09:00:00,330,160,170,Mäßiger Regenfall,8,5,1,
,2021-05-07 10:00:00,299,167,132,Mäßiger Regenfall,8,5,0.5,
,2021-05-07 11:00:00,467,264,203,Leichter Regenfall,8,5,0.6,
,2021-05-07 12:00:00,534,247,287,Leichter Regenfall,8,6,0.8,
,2021-05-07 13:00:00,571,262,309,Leichter Regenfall,8,6,0.4,
,2021-05-07 14:00:00,664,307,357,Leichter Regenfall,8,6,0.8,
,2021-05-07 15:00:00,674,352,322,Leichter Regenfall,8,6,1.1,
,2021-05-07 16:00:00,669,331,338,Leichter Regenfall,8,6,0.5,
,2021-05-07 17:00:00,650,321,329,Mäßiger Regenfall,8,6,1,
,2021-05-07 18:00:00,653,300,353,Mäßiger Regenfall,7,5,1.3,
,2021-05-07 19:00:00,430,230,200,Mäßiger Regenfall,7,5,0.6,
,2021-05-07 20:00:00,280,122,158,Mäßiger Regenfall,6,4,0.7,
,2021-05-07 21:00:00,215,103,112,Mäßiger Regenfall,6,4,0.9,
,2021-05-07 22:00:00,100,47,53,Mäßiger Regenfall,4,3,0.4,
,2021-05-07 23:00:00,86,45,41,Leichter Nebel,3,2,0,
,2021-05-08 00:00:00,44,17,27,Leichter Nebel,1,1,0,
,2021-05-08 01:00:00,13,9,4,Leichter Nebel,1,1,0,
,2021-05-08 02:00:00,7,5,2,Leichter Nebel,1,1,0,
,2021-05-08 03:00:00,5,3,2,Leichter Nebel,1,1,0,
,2021-05-08 04:00:00,13,9,4,Leichter Nebel,2,2,0,
,2021-05-08 05:00:00,34,17,17,Leichter Nebel,3,3,0,
,2021-05-08 06:00:00,54,27,27,Leichter Nebel,4,4,0,
,2021-05-08 07:00:00,108,62,46,Leichter Nebel,6,6,0,
,2021-05-08 08:00:00,257,142,115,Bewölkt,8,8,0,
,2021-05-08 09:00:00,462,249,213,Bewölkt,10,10,0,
,2021-05-08 10:00:00,719,419,300,Bewölkt,12,12,0,
,2021-05-08 11:00:00,800,448,352,Leicht bewölkt,13,13,0,
,2021-05-08 12:00:00,810,458,352,Leicht bewölkt,15,15,0,
,2021-05-08 13:00:00,942,547,395,Leicht bewölkt,15,15,0,
,2021-05-08 14:00:00,959,480,479,Leicht bewölkt,16,16,0,
,2021-05-08 15:00:00,926,491,435,Leicht bewölkt,17,17,0,
,2021-05-08 16:00:00,913,439,474,Leicht bewölkt,16,16,0,
,2021-05-08 17:00:00,866,419,447,Leicht bewölkt,15,15,0,
,2021-05-08 18:00:00,849,407,442,Leicht bewölkt,15,15,0,
,2021-05-08 19:00:00,500,248,252,Leicht bewölkt,13,13,0,
,2021-05-08 20:00:00,419,204,215,Leicht bewölkt,12,11,0,
,2021-05-08 21:00:00,354,158,196,Leicht bewölkt,10,10,0,
,2021-05-08 22:00:00,180,78,102,Leicht bewölkt,9,8,0,
,2021-05-08 23:00:00,111,46,65,Leicht bewölkt,8,7,0,
,2021-05-09 00:00:00,33,17,16,Leicht bewölkt,7,6,0,
,2021-05-09 01:00:00,21,9,12,Leicht bewölkt,7,6,0,
,2021-05-09 02:00:00,13,3,10,Bewölkt,7,5,0,
,2021-05-09 03:00:00,16,8,8,Bewölkt,6,5,0,
,2021-05-09 04:00:00,7,1,6,Bewölkt,7,6,0,
,2021-05-09 05:00:00,22,10,12,Leicht bewölkt,8,8,0,
,2021-05-09 06:00:00,37,24,13,Leicht bewölkt,9,9,0,
,2021-05-09 07:00:00,76,42,34,Leicht bewölkt,12,12,0,
,2021-05-09 08:00:00,139,71,68,Leicht bewölkt,14,14,0,
,2021-05-09 09:00:00,358,197,161,Leicht bewölkt,17,17,0,
,2021-05-09 10:00:00,531,277,254,Leicht bewölkt,18,18,0,
,2021-05-09 11:00:00,694,357,337,Leicht bewölkt,20,20,0,
,2021-05-09 12:00:00,831,398,433,Leicht bewölkt,22,23,0,
,2021-05-09 13:00:00,843,407,436,Leicht bewölkt,23,24,0,
,2021-05-09 14:00:00,909,474,435,Leicht bewölkt,24,24,0,
,2021-05-09 15:00:00,978,514,464,Leicht bewölkt,25,25,0,
,2021-05-09 16:00:00,859,471,388,Leicht bewölkt,24,26,0,
,2021-05-09 17:00:00,967,526,441,Leicht bewölkt,24,26,0,
,2021-05-09 18:00:00,781,466,315,Leicht bewölkt,24,27,0,
,2021-05-09 19:00:00,587,343,244,Leicht bewölkt,23,26,0,
,2021-05-09 20:00:00,466,254,212,Leicht bewölkt,22,22,0,
,2021-05-09 21:00:00,286,135,151,Leicht bewölkt,21,21,0,
,2021-05-09 22:00:00,105,41,64,Leicht bewölkt,18,17,0,
,2021-05-09 23:00:00,53,25,28,Leicht bewölkt,15,14,0,
,2021-05-10 00:00:00,16,4,12,Leicht bewölkt,12,11,0,
,2021-05-10 01:00:00,10,8,2,Leicht bewölkt,11,10,0,
,2021-05-10 02:00:00,3,1,2,Leicht bewölkt,10,9,0,
,2021-05-10 03:00:00,4,3,1,Leicht bewölkt,8,7,0,
,2021-05-10 04:00:00,3,1,2,Leicht bewölkt,9,9,0,
,2021-05-10 05:00:00,65,32,33,Leicht bewölkt,10,10,0,
,2021-05-10 06:00:00,203,124,79,Leicht bewölkt,12,12,0,
,2021-05-10 07:00:00,921,604,317,Leicht bewölkt,13,13,0,
,2021-05-10 08:00:00,898,516,382,Leicht bewölkt,15,15,0,
,2021-05-10 09:00:00,669,395,274,Leicht bewölkt,17,17,0,
,2021-05-10 10:00:00,549,309,240,Leicht bewölkt,17,18,0,
,2021-05-10 11:00:00,704,365,339,Leicht bewölkt,18,18,0,
,2021-05-10 12:00:00,861,397,464,Leicht bewölkt,19,19,0,
,2021-05-10 13:00:00,997,448,549,Leicht bewölkt,19,19,0,
,2021-05-10 14:00:00,841,449,392,Leicht bewölkt,20,20,0,
,2021-05-10 15:00:00,936,469,467,Leicht bewölkt,20,20,0,
,2021-05-10 16:00:00,984,504,480,Leicht bewölkt,19,19,0,
,2021-05-10 17:00:00,931,435,496,Leicht bewölkt,18,18,0,
,2021-05-10 18:00:00,846,378,468,Leicht bewölkt,17,17,0,
,2021-05-10 19:00:00,494,226,268,Leicht bewölkt,16,16,0,
,2021-05-10 20:00:00,355,156,199,Stellenweiser Regenfall,15,15,0,
,2021-05-10 21:00:00,219,93,126,Stellenweiser Regenfall,14,14,0,
,2021-05-10 22:00:00,78,32,46,Stellenweiser Regenfall,13,13,0,
,2021-05-10 23:00:00,54,33,21,Stellenweiser Regenfall,12,12,0,
,2021-05-11 00:00:00,16,7,9,Stellenweiser Regenfall,12,12,0.1,
,2021-05-11 01:00:00,5,3,2,Stellenweiser Regenfall,12,11,0,
,2021-05-11 02:00:00,1,0,1,Leichter Nebel,12,11,0,
,2021-05-11 03:00:00,2,1,1,Leichter Nebel,12,11,0,
,2021-05-11 04:00:00,4,3,1,Leichter Nebel,12,11,0,
,2021-05-11 05:00:00,49,26,23,Nieselregen,12,11,0.1,
,2021-05-11 06:00:00,196,120,76,Nieselregen,12,12,0.1,
,2021-05-11 07:00:00,845,516,329,Nieselregen,12,12,0.1,
,2021-05-11 08:00:00,817,487,330,Nieselregen,13,13,0,
,2021-05-11 09:00:00,692,429,263,Nieselregen,13,14,0,
,2021-05-11 10:00:00,598,346,252,Nieselregen,14,14,0,
,2021-05-11 11:00:00,682,342,340,Bewölkt,14,15,0,
,2021-05-11 12:00:00,819,348,471,Bewölkt,15,15,0,
,2021-05-11 13:00:00,863,387,476,Bewölkt,15,15,0,
,2021-05-11 14:00:00,720,354,366,Leichter Regenschauer,16,16,0.1,
,2021-05-11 15:00:00,584,266,318,Leichter Regenschauer,16,16,0.1,
,2021-05-11 16:00:00,624,278,346,Leichter Regenschauer,15,15,0.1,
,2021-05-11 17:00:00,529,256,273,Leichter Regenschauer,14,14,0.3,
,2021-05-11 18:00:00,494,205,289,Leichter Regenschauer,14,13,0.4,
,2021-05-11 19:00:00,290,156,134,Leichter Regenschauer,13,11,0.2,
,2021-05-11 20:00:00,154,80,74,Leichter Regenfall,12,10,0.9,
,2021-05-11 21:00:00,94,43,51,Leichter Regenfall,11,8,1.2,
,2021-05-11 22:00:00,58,26,32,Leichter Regenfall,10,8,0.6,
,2021-05-11 23:00:00,41,14,27,Mäßiger Regenfall,9,7,1.5,
,2021-05-12 00:00:00,17,5,12,Mäßiger Regenfall,9,7,2.9,
,2021-05-12 01:00:00,7,2,5,Mäßiger Regenfall,9,6,1.5,
,2021-05-12 02:00:00,4,1,3,Mäßiger Regenfall,8,6,1.4,
,2021-05-12 03:00:00,4,2,2,Mäßiger Regenfall,8,6,1.8,
,2021-05-12 04:00:00,2,2,0,Mäßiger Regenfall,8,5,0.9,
,2021-05-12 05:00:00,46,29,17,Mäßiger Regenfall,8,5,0.7,
,2021-05-12 06:00:00,140,87,53,Mäßiger Regenfall,7,4,0.9,
,2021-05-12 07:00:00,616,387,229,Mäßiger Regenfall,7,4,0.4,
,2021-05-12 08:00:00,589,331,258,Leichter Regenfall,7,3,1,
,2021-05-12 09:00:00,461,255,206,Leichter Regenfall,6,3,1.4,
,2021-05-12 10:00:00,284,144,140,Leichter Regenfall,6,3,0.7,
,2021-05-12 11:00:00,356,190,166,Mäßiger Regenfall,6,3,0.5,
,2021-05-12 12:00:00,484,245,239,Mäßiger Regenfall,6,3,0.6,
,2021-05-12 13:00:00,681,321,360,Mäßiger Regenfall,6,3,0.3,
,2021-05-12 14:00:00,538,304,234,Bedeckt,6,3,1.1,
,2021-05-12 15:00:00,585,288,297,Bedeckt,6,3,1.5,
,2021-05-12 16:00:00,757,387,370,Bedeckt,6,3,0.8,
,2021-05-12 17:00:00,774,366,408,Mäßiger Regenfall,6,3,1.5,
,2021-05-12 18:00:00,616,279,337,Mäßiger Regenfall,6,3,2,
,2021-05-12 19:00:00,438,219,219,Mäßiger Regenfall,5,2,1,
,2021-05-12 20:00:00,283,122,161,Mäßiger Regenfall,3,1,1.2,
,2021-05-12 21:00:00,177,93,84,Mäßiger Regenfall,2,1,1.6,
,2021-05-12 22:00:00,88,43,45,Mäßiger Regenfall,4,3,0.8,
,2021-05-12 23:00:00,75,32,43,Leichter Regenfall,6,5,0.2,
,2021-05-13 00:00:00,51,33,18,Leichter Regenfall,8,7,0.4,
,2021-05-13 01:00:00,56,19,37,Leichter Regenfall,8,7,0.2,
,2021-05-13 02:00:00,34,16,18,Leichter Nebel,8,7,0.7,
,2021-05-13 03:00:00,19,9,10,Leichter Nebel,8,7,0.9,
,2021-05-13 04:00:00,7,4,3,Leichter Nebel,8,6,0.4,
,2021-05-13 05:00:00,26,12,14,Mäßiger Regenfall,8,6,0.8,
,2021-05-13 06:00:00,35,26,9,Mäßiger Regenfall,8,6,1,
,2021-05-13 07:00:00,31,17,14,Mäßiger Regenfall,8,6,0.5,
,2021-05-13 08:00:00,116,60,56,Leichter Regenfall,8,7,0.5,
,2021-05-13 09:00:00,236,129,107,Leichter Regenfall,8,7,0.7,
,2021-05-13 10:00:00,362,204,158,Leichter Regenfall,9,7,0.3,
,2021-05-13 11:00:00,491,233,258,Leichter Regenfall,9,8,0.1,
,2021-05-13 12:00:00,519,262,257,Leichter Regenfall,9,9,0.2,
,2021-05-13 13:00:00,540,278,262,Leichter Regenfall,10,9,0.1,
,2021-05-13 14:00:00,514,263,251,Bedeckt,10,10,0.6,
,2021-05-13 15:00:00,531,285,246,Bedeckt,10,10,0.8,
,2021-05-13 16:00:00,583,304,279,Bedeckt,10,10,0.4,
,2021-05-13 17:00:00,550,278,272,Mäßiger Regenfall,10,10,0.7,
,2021-05-13 18:00:00,490,272,218,Mäßiger Regenfall,10,9,0.9,
,2021-05-13 19:00:00,361,184,177,Mäßiger Regenfall,10,9,0.4,
,2021-05-13 20:00:00,266,130,136,Leichter Regenschauer,9,9,0.4,
,2021-05-13 21:00:00,176,83,93,Leichter Regenschauer,9,8,0.5,
,2021-05-13 22:00:00,133,69,64,Leichter Regenschauer,8,7,0.3,
,2021-05-13 23:00:00,139,64,75,Leicht bewölkt,7,6,0,
,2021-05-14 00:00:00,64,28,36,Leicht bewölkt,6,5,0,
,2021-05-14 01:00:00,35,18,17,Leicht bewölkt,6,5,0,
,2021-05-14 02:00:00,18,7,11,Leicht bewölkt,6,5,0,
,2021-05-14 03:00:00,15,7,8,Leicht bewölkt,6,6,0,
,2021-05-14 04:00:00,9,7,2,Leicht bewölkt,6,6,0,
,2021-05-14 05:00:00,40,22,18,Bedeckt,7,7,0,
,2021-05-14 06:00:00,115,76,39,Bedeckt,8,7,0,
,2021-05-14 07:00:00,328,203,125,Bedeckt,9,8,0,
,2021-05-14 08:00:00,587,381,206,Bewölkt,10,9,0,
,2021-05-14 09:00:00,757,469,288,Bewölkt,11,11,0,
,2021-05-14 10:00:00,766,423,343,Bewölkt,12,12,0,
,2021-05-14 11:00:00,826,405,421,Stellenweiser Regenfall,13,13,0.1,
,2021-05-14 12:00:00,874,379,495,Stellenweiser Regenfall,14,14,0.1,
,2021-05-14 13:00:00,821,390,431,Stellenweiser Regenfall,14,14,0.1,
,2021-05-14 14:00:00,916,486,430,Leichter Regenschauer,14,15,0.3,
,2021-05-14 15:00:00,852,434,418,Leichter Regenschauer,15,15,0.4,
,2021-05-14 16:00:00,856,462,394,Leichter Regenschauer,14,14,0.2,
,2021-05-14 17:00:00,868,411,457,Leichter Regenschauer,13,13,0.5,
,2021-05-14 18:00:00,877,391,486,Leichter Regenschauer,12,12,0.7,
,2021-05-14 19:00:00,535,248,287,Leichter Regenschauer,10,10,0.3,
,2021-05-14 20:00:00,313,141,172,Stellenweiser Regenfall,9,8,0.3,
,2021-05-14 21:00:00,181,83,98,Stellenweiser Regenfall,7,6,0.4,
,2021-05-14 22:00:00,152,78,74,Stellenweiser Regenfall,7,6,0.2,
,2021-05-14 23:00:00,94,31,63,Mäßiger Regenfall,7,6,1.2,
,2021-05-15 00:00:00,94,39,55,Mäßiger Regenfall,6,5,2.5,
,2021-05-15 01:00:00,57,25,32,Mäßiger Regenfall,6,5,1.2,
,2021-05-15 02:00:00,22,8,14,Mäßiger Regenfall,5,4,0.5,
,2021-05-15 03:00:00,21,10,11,Mäßiger Regenfall,5,3,0.6,
,2021-05-15 04:00:00,23,21,2,Mäßiger Regenfall,5,4,0.3,
,2021-05-15 05:00:00,33,19,14,Bedeckt,6,5,0,
,2021-05-15 06:00:00,50,29,21,Bedeckt,7,6,0,
,2021-05-15 07:00:00,78,42,36,Bedeckt,9,8,0,
,2021-05-15 08:00:00,209,118,91,Leicht bewölkt,10,10,0,
,2021-05-15 09:00:00,404,266,138,Leicht bewölkt,11,11,0,
,2021-05-15 10:00:00,588,301,287,Leicht bewölkt,12,12,0,
,2021-05-15 11:00:00,639,325,314,Leicht bewölkt,13,13,0,
,2021-05-15 12:00:00,657,361,296,Leicht bewölkt,14,14,0,
,2021-05-15 13:00:00,655,301,354,Leicht bewölkt,14,13,0,
,2021-05-15 14:00:00,742,326,416,Bedeckt,13,12,0.1,
,2021-05-15 15:00:00,607,310,297,Bedeckt,12,11,0.1,
,2021-05-15 16:00:00,528,244,284,Bedeckt,11,10,0,
,2021-05-15 17:00:00,371,174,197,Nieselregen,10,8,0,
,2021-05-15 18:00:00,325,137,188,Nieselregen,9,7,0,
,2021-05-15 19:00:00,204,99,105,Nieselregen,9,6,0,
,2021-05-15 20:00:00,125,53,72,Leichter Nebel,8,6,0.8,
,2021-05-15 21:00:00,151,61,90,Leichter Nebel,8,6,1,
,2021-05-15 22:00:00,74,29,45,Leichter Nebel,8,6,0.5,
,2021-05-15 23:00:00,80,35,45,Mäßiger Regenfall,7,6,1.7,
,2021-05-16 00:00:00,74,32,42,Mäßiger Regenfall,7,6,3.3,
,2021-05-16 01:00:00,32,16,16,Mäßiger Regenfall,7,6,1.7,
,2021-05-16 02:00:00,25,13,12,Mäßiger Regenfall,7,6,0.7,
,2021-05-16 03:00:00,20,12,8,Mäßiger Regenfall,7,6,1,
,2021-05-16 04:00:00,9,5,4,Mäßiger Regenfall,7,6,0.5,
,2021-05-16 05:00:00,17,6,11,Stellenweiser leichter Regenfall,8,7,0.7,
,2021-05-16 06:00:00,41,17,24,Stellenweiser leichter Regenfall,8,7,0.9,
,2021-05-16 07:00:00,30,17,13,Stellenweiser leichter Regenfall,8,8,0.5,
,2021-05-16 08:00:00,71,38,33,Mäßiger Regenfall,9,8,0.7,
,2021-05-16 09:00:00,198,104,94,Mäßiger Regenfall,9,9,0.9,
,2021-05-16 10:00:00,273,145,128,Mäßiger Regenfall,10,10,0.4,
,2021-05-16 11:00:00,337,179,158,Leichter Regenfall,11,11,0.4,
,2021-05-16 12:00:00,360,154,206,Leichter Regenfall,12,12,0.5,
,2021-05-16 13:00:00,409,184,225,Leichter Regenfall,13,12,0.3,
,2021-05-16 14:00:00,227,104,123,Leichter Regenfall,13,12,0.8,
,2021-05-16 15:00:00,217,102,115,Leichter Regenfall,13,12,1,
,2021-05-16 16:00:00,144,74,70,Leichter Regenfall,12,11,0.5,
,2021-05-16 17:00:00,141,71,70,Mäßiger Regenfall,11,10,1.6,
,2021-05-16 18:00:00,121,61,60,Mäßiger Regenfall,10,9,2.2,
,2021-05-16 19:00:00,172,76,96,Mäßiger Regenfall,10,8,1.1,
,2021-05-16 20:00:00,113,58,55,Teilweise mäßiger Regenfall,9,8,1,
,2021-05-16 21:00:00,67,27,40,Teilweise mäßiger Regenfall,9,7,1.3,
,2021-05-16 22:00:00,34,19,15,Teilweise mäßiger Regenfall,8,7,0.7,
,2021-05-16 23:00:00,36,22,14,Stellenweiser leichter Regenfall,8,7,0.8,
,2021-05-17 00:00:00,19,10,9,Stellenweiser leichter Regenfall,8,6,1.7,
,2021-05-17 01:00:00,18,15,3,Stellenweiser leichter Regenfall,8,6,0.8,
,2021-05-17 02:00:00,7,1,6,Teilweise mäßiger Regenfall,7,5,0.4,
,2021-05-17 03:00:00,3,1,2,Teilweise mäßiger Regenfall,7,5,0.5,
,2021-05-17 04:00:00,10,10,0,Teilweise mäßiger Regenfall,7,5,0.2,
,2021-05-17 05:00:00,43,28,15,Stellenweiser Regenfall,8,5,0.1,
,2021-05-17 06:00:00,156,99,57,Stellenweiser Regenfall,8,6,0.2,
,2021-05-17 07:00:00,647,395,252,Stellenweiser Regenfall,9,7,0.1,
,2021-05-17 08:00:00,649,381,268,Stellenweiser Regenfall,10,8,0,
,2021-05-17 09:00:00,456,286,170,Stellenweiser Regenfall,12,10,0,
,2021-05-17 10:00:00,312,172,140,Stellenweiser Regenfall,13,11,0,
,2021-05-17 11:00:00,423,218,205,Leicht bewölkt,14,12,0,
,2021-05-17 12:00:00,533,229,304,Leicht bewölkt,15,14,0,
,2021-05-17 13:00:00,603,291,312,Leicht bewölkt,15,14,0,
,2021-05-17 14:00:00,502,248,254,Leicht bewölkt,15,14,0.1,
,2021-05-17 15:00:00,541,242,299,Leicht bewölkt,15,14,0.1,
,2021-05-17 16:00:00,607,285,322,Leicht bewölkt,14,13,0,
,2021-05-17 17:00:00,708,331,377,Stellenweiser Regenfall,13,11,0.2,
,2021-05-17 18:00:00,540,224,316,Stellenweiser Regenfall,12,10,0.2,
,2021-05-17 19:00:00,387,179,208,Stellenweiser Regenfall,11,9,0.1,
,2021-05-17 20:00:00,242,106,136,Leichter Regenschauer,10,7,0.5,
,2021-05-17 21:00:00,155,67,88,Leichter Regenschauer,9,6,0.6,
,2021-05-17 22:00:00,91,43,48,Leichter Regenschauer,8,6,0.3,
,2021-05-17 23:00:00,41,21,20,Leichter Regenschauer,8,5,0.3,
,2021-05-18 00:00:00,31,14,17,Leichter Regenschauer,8,5,0.7,
,2021-05-18 01:00:00,19,9,10,Leichter Regenschauer,8,5,0.3,
,2021-05-18 02:00:00,9,5,4,Leichter Regenschauer,8,5,0.2,
,2021-05-18 03:00:00,1,1,0,Leichter Regenschauer,8,5,0.3,
,2021-05-18 04:00:00,3,3,0,Leichter Regenschauer,8,5,0.2,
,2021-05-18 05:00:00,37,22,15,Nieselregen,8,5,0.1,
,2021-05-18 06:00:00,157,94,63,Nieselregen,8,5,0.1,
,2021-05-18 07:00:00,649,401,248,Nieselregen,8,5,0,
,2021-05-18 08:00:00,631,372,259,Leicht bewölkt,9,6,0.1,
,2021-05-18 09:00:00,544,311,233,Leicht bewölkt,9,6,0.1,
,2021-05-18 10:00:00,370,201,169,Leicht bewölkt,9,6,0.1,
,2021-05-18 11:00:00,443,221,222,Leichter Regenschauer,9,6,0,
,2021-05-18 12:00:00,466,213,253,Leichter Regenschauer,10,7,0,
,2021-05-18 13:00:00,713,305,408,Leichter Regenschauer,10,7,0,
,2021-05-18 14:00:00,619,313,306,Bewölkt,10,7,0.3,
,2021-05-18 15:00:00,637,320,317,Bewölkt,10,7,0.4,
,2021-05-18 16:00:00,785,397,388,Bewölkt,10,7,0.2,
,2021-05-18 17:00:00,774,342,432,Leichter Regenschauer,9,7,0.2,
,2021-05-18 18:00:00,747,308,439,Leichter Regenschauer,9,7,0.3,
,2021-05-18 19:00:00,477,207,270,Leichter Regenschauer,8,6,0.1,
,2021-05-18 20:00:00,317,152,165,Leichter Regenschauer,8,5,0.1,
,2021-05-18 21:00:00,192,79,113,Leichter Regenschauer,7,5,0.2,
,2021-05-18 22:00:00,106,43,63,Leichter Regenschauer,6,5,0.1,
,2021-05-18 23:00:00,74,34,40,Stellenweiser Regenfall,6,5,0.2,
,2021-05-19 00:00:00,34,13,21,Stellenweiser Regenfall,6,5,0.3,
,2021-05-19 01:00:00,13,10,3,Stellenweiser Regenfall,5,4,0.2,
,2021-05-19 02:00:00,3,1,2,Stellenweiser Regenfall,5,3,0.1,
,2021-05-19 03:00:00,3,2,1,Stellenweiser Regenfall,4,3,0.1,
,2021-05-19 04:00:00,6,5,1,Stellenweiser Regenfall,5,4,0,
,2021-05-19 05:00:00,42,25,17,Leicht bewölkt,6,5,0,
,2021-05-19 06:00:00,151,91,60,Leicht bewölkt,6,6,0,
,2021-05-19 07:00:00,695,427,268,Leicht bewölkt,8,7,0,
,2021-05-19 08:00:00,667,394,273,Leicht bewölkt,9,9,0,
,2021-05-19 09:00:00,565,304,261,Leicht bewölkt,11,11,0,
,2021-05-19 10:00:00,408,214,194,Leicht bewölkt,12,12,0,
,2021-05-19 11:00:00,417,203,214,Stellenweiser Regenfall,13,13,0,
,2021-05-19 12:00:00,506,229,277,Stellenweiser Regenfall,14,14,0,
,2021-05-19 13:00:00,732,340,392,Stellenweiser Regenfall,14,13,0,
,2021-05-19 14:00:00,630,328,302,Leicht bewölkt,13,13,0.4,
,2021-05-19 15:00:00,697,319,378,Leicht bewölkt,13,12,0.6,
,2021-05-19 16:00:00,581,288,293,Leicht bewölkt,12,11,0.3,
,2021-05-19 17:00:00,632,273,359,Leichter Regenschauer,11,10,0.6,
,2021-05-19 18:00:00,600,284,316,Leichter Regenschauer,10,10,0.8,
,2021-05-19 19:00:00,378,180,198,Leichter Regenschauer,9,8,0.4,
,2021-05-19 20:00:00,249,103,146,Leichter Regenschauer,8,7,0.4,
,2021-05-19 21:00:00,171,83,88,Leichter Regenschauer,7,6,0.5,
,2021-05-19 22:00:00,100,31,69,Leichter Regenschauer,7,6,0.3,
,2021-05-19 23:00:00,82,33,49,Leichter Regenschauer,6,5,0.4,
,2021-05-20 00:00:00,57,19,38,Leichter Regenschauer,6,4,0.8,
,2021-05-20 01:00:00,25,12,13,Leichter Regenschauer,6,4,0.4,
,2021-05-20 02:00:00,12,4,8,Leichter Regenfall,6,4,0.4,
,2021-05-20 03:00:00,1,0,1,Leichter Regenfall,6,4,0.5,
,2021-05-20 04:00:00,12,7,5,Leichter Regenfall,6,4,0.2,
,2021-05-20 05:00:00,50,33,17,Leichter Regenfall,6,4,0.2,
,2021-05-20 06:00:00,134,78,56,Leichter Regenfall,6,4,0.3,
,2021-05-20 07:00:00,627,384,243,Leichter Regenfall,6,4,0.1,
,2021-05-20 08:00:00,582,316,266,Nieselregen,7,4,0.3,
,2021-05-20 09:00:00,464,254,210,Nieselregen,7,4,0.4,
,2021-05-20 10:00:00,360,199,161,Nieselregen,7,5,0.2,
,2021-05-20 11:00:00,453,230,223,Leichter Regenfall,8,6,0.2,
,2021-05-20 12:00:00,492,209,283,Leichter Regenfall,8,6,0.2,
,2021-05-20 13:00:00,670,320,350,Leichter Regenfall,9,8,0.1,
,2021-05-20 14:00:00,614,330,284,Nieselregen,10,9,0.2,
,2021-05-20 15:00:00,691,358,333,Nieselregen,11,10,0.2,
,2021-05-20 16:00:00,727,350,377,Nieselregen,11,10,0.1,
,2021-05-20 17:00:00,790,389,401,Stellenweiser Regenfall,10,10,0.1,
,2021-05-20 18:00:00,759,332,427,Stellenweiser Regenfall,10,10,0.1,
,2021-05-20 19:00:00,515,257,258,Stellenweiser Regenfall,9,9,0,
,2021-05-20 20:00:00,349,129,220,Leicht bewölkt,8,7,0,
,2021-05-20 21:00:00,233,89,144,Leicht bewölkt,7,6,0,
,2021-05-20 22:00:00,144,58,86,Leicht bewölkt,7,6,0,
,2021-05-20 23:00:00,67,41,26,Leicht bewölkt,6,6,0,
,2021-05-21 00:00:00,30,12,18,Leicht bewölkt,6,5,0,
,2021-05-21 01:00:00,37,19,18,Leicht bewölkt,6,5,0,
,2021-05-21 02:00:00,18,11,7,Leicht bewölkt,6,5,0,
,2021-05-21 03:00:00,9,4,5,Leicht bewölkt,6,5,0,
,2021-05-21 04:00:00,9,4,5,Leicht bewölkt,7,6,0,
,2021-05-21 05:00:00,42,28,14,Leicht bewölkt,7,7,0,
,2021-05-21 06:00:00,143,98,45,Leicht bewölkt,8,8,0,
,2021-05-21 07:00:00,624,397,227,Leicht bewölkt,9,9,0,
,2021-05-21 08:00:00,579,339,240,Bedeckt,11,10,0,
,2021-05-21 09:00:00,564,344,220,Bedeckt,12,11,0,
,2021-05-21 10:00:00,400,180,220,Bedeckt,13,13,0,
,2021-05-21 11:00:00,339,150,189,Bewölkt,14,14,0,
,2021-05-21 12:00:00,449,209,240,Bewölkt,15,15,0,
,2021-05-21 13:00:00,601,235,366,Bewölkt,15,14,0,
,2021-05-21 14:00:00,460,224,236,Leicht bewölkt,15,14,0,
,2021-05-21 15:00:00,399,181,218,Leicht bewölkt,14,14,0,
,2021-05-21 16:00:00,391,198,193,Leicht bewölkt,14,13,0,
,2021-05-21 17:00:00,357,194,163,Stellenweiser Nieselregen,13,12,0,
,2021-05-21 18:00:00,311,143,168,Stellenweiser Nieselregen,12,11,0,
,2021-05-21 19:00:00,196,98,98,Stellenweiser Nieselregen,11,11,0,
,2021-05-21 20:00:00,173,76,97,Leichter Nebel,11,10,0.7,
,2021-05-21 21:00:00,94,23,71,Leichter Nebel,10,10,0.9,
,2021-05-21 22:00:00,73,34,39,Leichter Nebel,10,9,0.5,
,2021-05-21 23:00:00,46,23,23,Mäßiger Regenfall,9,7,1.3,
,2021-05-22 00:00:00,46,22,24,Mäßiger Regenfall,8,5,2.6,
,2021-05-22 01:00:00,26,12,14,Mäßiger Regenfall,8,5,1.3,
,2021-05-22 02:00:00,22,8,14,Mäßiger Regenfall,7,5,0.6,
,2021-05-22 03:00:00,8,3,5,Mäßiger Regenfall,7,5,0.8,
,2021-05-22 04:00:00,18,14,4,Mäßiger Regenfall,7,5,0.4,
,2021-05-22 05:00:00,22,14,8,Leichter Regenfall,7,5,0.1,
,2021-05-22 06:00:00,41,28,13,Leichter Regenfall,8,5,0.2,
,2021-05-22 07:00:00,73,31,42,Leichter Regenfall,8,6,0.1,
,2021-05-22 08:00:00,208,121,87,Bewölkt,9,7,0,
,2021-05-22 09:00:00,363,216,147,Bewölkt,10,8,0,
,2021-05-22 10:00:00,466,257,209,Bewölkt,11,9,0,
,2021-05-22 11:00:00,571,317,254,Leichter Regenschauer,12,11,0,
,2021-05-22 12:00:00,608,320,288,Leichter Regenschauer,13,12,0,
,2021-05-22 13:00:00,664,312,352,Leichter Regenschauer,14,13,0,
,2021-05-22 14:00:00,693,366,327,Leicht bewölkt,15,14,0,
,2021-05-22 15:00:00,635,322,313,Leicht bewölkt,16,15,0,
,2021-05-22 16:00:00,617,302,315,Leicht bewölkt,15,14,0,
,2021-05-22 17:00:00,632,303,329,Stellenweiser Regenfall,14,13,0.1,
,2021-05-22 18:00:00,661,315,346,Stellenweiser Regenfall,13,13,0.1,
,2021-05-22 19:00:00,439,237,202,Stellenweiser Regenfall,12,11,0,
,2021-05-22 20:00:00,399,182,217,Stellenweiser Regenfall,11,10,0,
,2021-05-22 21:00:00,272,113,159,Stellenweiser Regenfall,9,8,0,
,2021-05-22 22:00:00,201,76,125,Stellenweiser Regenfall,8,7,0,
,2021-05-22 23:00:00,136,48,88,Bedeckt,7,5,0.6,
,2021-05-23 00:00:00,86,27,59,Bedeckt,6,4,1.3,
,2021-05-23 01:00:00,77,33,44,Bedeckt,6,4,0.6,
,2021-05-23 02:00:00,41,19,22,Mäßiger Regenfall,6,4,0.8,
,2021-05-23 03:00:00,18,12,6,Mäßiger Regenfall,6,3,1.1,
,2021-05-23 04:00:00,15,4,11,Mäßiger Regenfall,7,4,0.6,
,2021-05-23 05:00:00,16,8,8,Leichter Regenfall,7,4,0.3,
,2021-05-23 06:00:00,31,18,13,Leichter Regenfall,7,5,0.4,
,2021-05-23 07:00:00,25,12,13,Leichter Regenfall,8,6,0.2,
,2021-05-23 08:00:00,54,29,25,Bewölkt,9,7,0.1,
,2021-05-23 09:00:00,154,90,64,Bewölkt,11,9,0.1,
,2021-05-23 10:00:00,254,136,118,Bewölkt,12,10,0.1,
,2021-05-23 11:00:00,359,192,167,Stellenweiser Regenfall,13,12,0,
,2021-05-23 12:00:00,445,229,216,Stellenweiser Regenfall,14,14,0,
,2021-05-23 13:00:00,457,204,253,Stellenweiser Regenfall,15,15,0,
,2021-05-23 14:00:00,514,264,250,Leicht bewölkt,16,16,0,
,2021-05-23 15:00:00,528,306,222,Leicht bewölkt,17,17,0,
,2021-05-23 16:00:00,581,292,289,Leicht bewölkt,16,16,0,
,2021-05-23 17:00:00,562,285,277,Leicht bewölkt,15,16,0,
,2021-05-23 18:00:00,504,276,228,Leicht bewölkt,15,15,0,
,2021-05-23 19:00:00,453,214,239,Leicht bewölkt,14,14,0,
,2021-05-23 20:00:00,341,156,185,Leicht bewölkt,13,14,0,
,2021-05-23 21:00:00,270,105,165,Leicht bewölkt,13,13,0,
,2021-05-23 22:00:00,130,43,87,Leicht bewölkt,11,11,0,
,2021-05-23 23:00:00,99,34,65,Leicht bewölkt,9,9,0,
,2021-05-24 00:00:00,51,20,31,Leicht bewölkt,7,7,0,
,2021-05-24 01:00:00,41,17,24,Leicht bewölkt,7,7,0,
,2021-05-24 02:00:00,20,7,13,Leicht bewölkt,7,7,0,
,2021-05-24 03:00:00,14,8,6,Leicht bewölkt,7,7,0,
,2021-05-24 04:00:00,15,8,7,Leicht bewölkt,8,8,0,
,2021-05-24 05:00:00,13,9,4,Leicht bewölkt,9,9,0,
,2021-05-24 06:00:00,29,23,6,Leicht bewölkt,10,10,0,
,2021-05-24 07:00:00,36,22,14,Leicht bewölkt,10,10,0,
,2021-05-24 08:00:00,91,51,40,Leicht bewölkt,11,10,0,
,2021-05-24 09:00:00,173,87,86,Leicht bewölkt,11,11,0,
,2021-05-24 10:00:00,280,157,123,Leicht bewölkt,11,10,0,
,2021-05-24 11:00:00,325,170,155,Stellenweiser Regenfall,11,10,0.2,
,2021-05-24 12:00:00,316,164,152,Stellenweiser Regenfall,11,10,0.2,
,2021-05-24 13:00:00,382,216,166,Stellenweiser Regenfall,10,10,0.1,
,2021-05-24 14:00:00,411,202,209,Nieselregen,10,10,0.4,
,2021-05-24 15:00:00,447,210,237,Nieselregen,10,11,0.5,
,2021-05-24 16:00:00,286,131,155,Nieselregen,10,10,0.3,
,2021-05-24 17:00:00,276,119,157,Leichter Regenfall,10,10,0.2,
,2021-05-24 18:00:00,246,123,123,Leichter Regenfall,10,10,0.3,
,2021-05-24 19:00:00,233,99,134,Leichter Regenfall,10,9,0.1,
,2021-05-24 20:00:00,189,83,106,Leichter Nebel,10,9,0.3,
,2021-05-24 21:00:00,115,54,61,Leichter Nebel,9,9,0.4,
,2021-05-24 22:00:00,66,37,29,Leichter Nebel,9,8,0.2,
,2021-05-24 23:00:00,46,21,25,Leichter Regenfall,9,7,0.6,
,2021-05-25 00:00:00,27,13,14,Leichter Regenfall,9,6,1.3,
,2021-05-25 01:00:00,11,4,7,Leichter Regenfall,8,5,0.6,
,2021-05-25 02:00:00,16,12,4,Leichter Regenfall,7,5,0.6,
,2021-05-25 03:00:00,4,2,2,Leichter Regenfall,7,4,0.8,
,2021-05-25 04:00:00,7,5,2,Leichter Regenfall,7,4,0.4,
,2021-05-25 05:00:00,42,29,13,Leichter Regenfall,6,4,0.7,
,2021-05-25 06:00:00,169,109,60,Leichter Regenfall,6,3,0.9,
,2021-05-25 07:00:00,307,190,117,Leichter Regenfall,7,4,0.5,
,2021-05-25 08:00:00,461,261,200,Leichter Regenfall,8,5,0.3,
,2021-05-25 09:00:00,431,245,186,Leichter Regenfall,8,6,0.4,
,2021-05-25 10:00:00,410,224,186,Leichter Regenfall,10,7,0.2,
,2021-05-25 11:00:00,474,245,229,Leichter Regenschauer,11,9,0,
,2021-05-25 12:00:00,483,241,242,Leichter Regenschauer,13,11,0,
,2021-05-25 13:00:00,510,256,254,Leichter Regenschauer,13,12,0,
,2021-05-25 14:00:00,600,331,269,Bedeckt,14,13,0,
,2021-05-25 15:00:00,641,309,332,Bedeckt,15,14,0,
,2021-05-25 16:00:00,709,359,350,Bedeckt,14,14,0,
,2021-05-25 17:00:00,832,419,413,Leicht bewölkt,14,13,0,
,2021-05-25 18:00:00,733,318,415,Leicht bewölkt,13,13,0,
,2021-05-25 19:00:00,491,202,289,Leicht bewölkt,12,12,0,
,2021-05-25 20:00:00,365,147,218,Leicht bewölkt,12,11,0,
,2021-05-25 21:00:00,253,118,135,Leicht bewölkt,11,11,0,
,2021-05-25 22:00:00,118,44,74,Leicht bewölkt,9,9,0,
,2021-05-25 23:00:00,75,33,42,Leicht bewölkt,7,7,0,
,2021-05-26 00:00:00,47,23,24,Leicht bewölkt,5,5,0,
,2021-05-26 01:00:00,17,7,10,Leicht bewölkt,5,4,0,
,2021-05-26 02:00:00,9,5,4,Leicht bewölkt,5,4,0,
,2021-05-26 03:00:00,6,4,2,Leicht bewölkt,5,4,0,
,2021-05-26 04:00:00,10,6,4,Leicht bewölkt,6,5,0,
,2021-05-26 05:00:00,47,27,20,Bedeckt,7,6,0,
,2021-05-26 06:00:00,147,88,59,Bedeckt,9,8,0,
,2021-05-26 07:00:00,300,156,144,Bedeckt,10,9,0,
,2021-05-26 08:00:00,478,265,213,Leicht bewölkt,12,11,0,
,2021-05-26 09:00:00,457,257,200,Leicht bewölkt,13,12,0,
,2021-05-26 10:00:00,449,253,196,Leicht bewölkt,14,13,0,
,2021-05-26 11:00:00,491,230,261,Leicht bewölkt,15,15,0,
,2021-05-26 12:00:00,553,263,290,Leicht bewölkt,16,16,0,
,2021-05-26 13:00:00,536,277,259,Leicht bewölkt,16,16,0,
,2021-05-26 14:00:00,522,248,274,Leicht bewölkt,17,16,0,
,2021-05-26 15:00:00,589,287,302,Leicht bewölkt,17,17,0,
,2021-05-26 16:00:00,535,260,275,Leicht bewölkt,16,15,0,
,2021-05-26 17:00:00,645,294,351,Leicht bewölkt,15,14,0,
,2021-05-26 18:00:00,546,247,299,Leicht bewölkt,14,13,0,
,2021-05-26 19:00:00,351,152,199,Leicht bewölkt,13,12,0,
,2021-05-26 20:00:00,259,102,157,Bewölkt,12,11,0.2,
,2021-05-26 21:00:00,147,58,89,Bewölkt,11,10,0.2,
,2021-05-26 22:00:00,86,53,33,Bewölkt,10,9,0.1,
,2021-05-26 23:00:00,54,22,32,Leichter Regenfall,9,8,1.2,
,2021-05-27 00:00:00,31,16,15,Leichter Regenfall,8,7,2.4,
,2021-05-27 01:00:00,10,5,5,Leichter Regenfall,8,7,1.2,
,2021-05-27 02:00:00,13,9,4,Mäßiger Regenfall,8,7,1.2,
,2021-05-27 03:00:00,7,4,3,Mäßiger Regenfall,8,8,1.6,
,2021-05-27 04:00:00,9,5,4,Mäßiger Regenfall,8,8,0.8,
,2021-05-27 05:00:00,25,15,10,Mäßiger Regenfall,8,8,1.9,
,2021-05-27 06:00:00,104,63,41,Mäßiger Regenfall,9,9,2.5,
,2021-05-27 07:00:00,248,144,104,Mäßiger Regenfall,9,9,1.3,
,2021-05-27 08:00:00,337,186,151,Mäßiger Regenfall,10,9,1.3,
,2021-05-27 09:00:00,291,159,132,Mäßiger Regenfall,10,9,1.8,
,2021-05-27 10:00:00,261,163,98,Mäßiger Regenfall,10,9,0.9,
,2021-05-27 11:00:00,217,119,98,Mäßiger Regenfall,11,10,0.8,
,2021-05-27 12:00:00,266,115,151,Mäßiger Regenfall,11,10,1,
,2021-05-27 13:00:00,283,142,141,Mäßiger Regenfall,12,11,0.5,
,2021-05-27 14:00:00,510,296,214,Stellenweiser leichter Regenfall,13,12,0.2,
,2021-05-27 15:00:00,500,268,232,Stellenweiser leichter Regenfall,14,14,0.3,
,2021-05-27 16:00:00,635,336,299,Stellenweiser leichter Regenfall,14,14,0.2,
,2021-05-27 17:00:00,728,331,397,Leicht bewölkt,14,14,0,
,2021-05-27 18:00:00,665,303,362,Leicht bewölkt,14,14,0,
,2021-05-27 19:00:00,486,254,232,Leicht bewölkt,13,13,0,
,2021-05-27 20:00:00,334,159,175,Leicht bewölkt,12,12,0,
,2021-05-27 21:00:00,250,100,150,Leicht bewölkt,11,11,0,
,2021-05-27 22:00:00,152,60,92,Leicht bewölkt,9,9,0,
,2021-05-27 23:00:00,81,36,45,Stellenweiser Regenfall,8,8,0.1,
,2021-05-28 00:00:00,52,20,32,Stellenweiser Regenfall,6,6,0.1,
,2021-05-28 01:00:00,28,13,15,Stellenweiser Regenfall,6,6,0.1,
,2021-05-28 02:00:00,16,8,8,Stellenweiser Regenfall,6,6,0,
,2021-05-28 03:00:00,4,2,2,Stellenweiser Regenfall,5,5,0,
,2021-05-28 04:00:00,9,6,3,Stellenweiser Regenfall,6,6,0,
,2021-05-28 05:00:00,41,25,16,Leicht bewölkt,7,7,0,
,2021-05-28 06:00:00,142,86,56,Leicht bewölkt,8,8,0,
,2021-05-28 07:00:00,350,194,156,Leicht bewölkt,10,10,0,
,2021-05-28 08:00:00,470,275,195,Leicht bewölkt,11,11,0,
,2021-05-28 09:00:00,516,311,205,Leicht bewölkt,13,13,0,
,2021-05-28 10:00:00,589,324,265,Leicht bewölkt,14,14,0,
,2021-05-28 11:00:00,603,315,288,Leicht bewölkt,15,15,0,
,2021-05-28 12:00:00,356,196,160,Leicht bewölkt,16,16,0,
,2021-05-28 13:00:00,0,0,0,Leicht bewölkt,16,16,0,
,2021-05-28 14:00:00,0,0,0,Leicht bewölkt,16,16,0,
,2021-05-28 15:00:00,0,0,0,Leicht bewölkt,17,17,0,
,2021-05-28 16:00:00,0,0,0,Leicht bewölkt,16,16,0,
,2021-05-28 17:00:00,0,0,0,Leicht bewölkt,15,15,0,
,2021-05-28 18:00:00,0,0,0,Leicht bewölkt,15,14,0,
,2021-05-28 19:00:00,0,0,0,Leicht bewölkt,13,13,0,
,2021-05-28 20:00:00,0,0,0,Leicht bewölkt,12,12,0,
,2021-05-28 21:00:00,0,0,0,Leicht bewölkt,11,10,0,
,2021-05-28 22:00:00,0,0,0,Leicht bewölkt,10,10,0,
,2021-05-28 23:00:00,0,0,0,Leicht bewölkt,9,9,0,
,2021-05-29 00:00:00,0,0,0,Leicht bewölkt,9,8,0,
,2021-05-29 01:00:00,0,0,0,Leicht bewölkt,8,8,0,
,2021-05-29 02:00:00,0,0,0,Bedeckt,8,7,0,
,2021-05-29 03:00:00,0,0,0,Bedeckt,7,7,0,
,2021-05-29 04:00:00,0,0,0,Bedeckt,8,7,0,
,2021-05-29 05:00:00,0,0,0,Bedeckt,9,8,0,
,2021-05-29 06:00:00,0,0,0,Bedeckt,10,9,0,
,2021-05-29 07:00:00,0,0,0,Bedeckt,11,10,0,
,2021-05-29 08:00:00,0,0,0,Bedeckt,12,11,0,
,2021-05-29 09:00:00,0,0,0,Bedeckt,13,13,0,
,2021-05-29 10:00:00,0,0,0,Bedeckt,14,14,0,
,2021-05-29 11:00:00,0,0,0,Bedeckt,15,15,0,
,2021-05-29 12:00:00,0,0,0,Bedeckt,16,16,0,
,2021-05-29 13:00:00,0,0,0,Bedeckt,16,16,0,
,2021-05-29 14:00:00,0,0,0,Stellenweiser Regenfall,16,16,0.1,
,2021-05-29 15:00:00,0,0,0,Stellenweiser Regenfall,17,17,0.1,
,2021-05-29 16:00:00,0,0,0,Stellenweiser Regenfall,16,16,0.1,
,2021-05-29 17:00:00,0,0,0,Stellenweiser Regenfall,15,15,0.2,
,2021-05-29 18:00:00,0,0,0,Stellenweiser Regenfall,14,13,0.2,
,2021-05-29 19:00:00,0,0,0,Stellenweiser Regenfall,13,12,0.1,
,2021-05-29 20:00:00,0,0,0,Teilweise mäßiger Regenfall,12,12,0.1,
,2021-05-29 21:00:00,0,0,0,Teilweise mäßiger Regenfall,11,11,0.1,
,2021-05-29 22:00:00,0,0,0,Teilweise mäßiger Regenfall,10,9,0,
,2021-05-29 23:00:00,0,0,0,Leicht bewölkt,9,8,0,
,2021-05-30 00:00:00,0,0,0,Leicht bewölkt,8,7,0,
,2021-05-30 01:00:00,0,0,0,Leicht bewölkt,7,6,0,
,2021-05-30 02:00:00,0,0,0,Leicht bewölkt,7,5,0,
,2021-05-30 03:00:00,0,0,0,Leicht bewölkt,6,5,0,
,2021-05-30 04:00:00,0,0,0,Leicht bewölkt,7,6,0,
,2021-05-30 05:00:00,0,0,0,Leicht bewölkt,8,7,0,
,2021-05-30 06:00:00,0,0,0,Leicht bewölkt,9,8,0,
,2021-05-30 07:00:00,0,0,0,Leicht bewölkt,11,10,0,
,2021-05-30 08:00:00,0,0,0,Leicht bewölkt,12,12,0,
,2021-05-30 09:00:00,0,0,0,Leicht bewölkt,14,14,0,
,2021-05-30 10:00:00,0,0,0,Leicht bewölkt,15,15,0,
,2021-05-30 11:00:00,0,0,0,Leicht bewölkt,17,16,0,
,2021-05-30 12:00:00,0,0,0,Leicht bewölkt,18,18,0,
,2021-05-30 13:00:00,0,0,0,Leicht bewölkt,18,18,0,
,2021-05-30 14:00:00,0,0,0,Leicht bewölkt,18,18,0,
,2021-05-30 15:00:00,0,0,0,Leicht bewölkt,18,18,0,
,2021-05-30 16:00:00,0,0,0,Leicht bewölkt,17,17,0,
,2021-05-30 17:00:00,0,0,0,Leicht bewölkt,16,16,0,
,2021-05-30 18:00:00,0,0,0,Leicht bewölkt,15,14,0,
,2021-05-30 19:00:00,0,0,0,Leicht bewölkt,14,13,0,
,2021-05-30 20:00:00,0,0,0,Leicht bewölkt,12,11,0,
,2021-05-30 21:00:00,0,0,0,Leicht bewölkt,11,9,0,
,2021-05-30 22:00:00,0,0,0,Leicht bewölkt,9,8,0,
,2021-05-30 23:00:00,0,0,0,Leicht bewölkt,8,7,0,
,2021-05-31 00:00:00,0,0,0,Leicht bewölkt,7,6,0,
,2021-05-31 01:00:00,0,0,0,Leicht bewölkt,6,5,0,
,2021-05-31 02:00:00,0,0,0,Sonnig,6,5,0,
,2021-05-31 03:00:00,0,0,0,Sonnig,5,4,0,
,2021-05-31 04:00:00,0,0,0,Sonnig,6,5,0,
,2021-05-31 05:00:00,0,0,0,Sonnig,7,6,0,
,2021-05-31 06:00:00,0,0,0,Sonnig,8,7,0,
,2021-05-31 07:00:00,0,0,0,Sonnig,10,9,0,
,2021-05-31 08:00:00,0,0,0,Sonnig,11,11,0,
,2021-05-31 09:00:00,0,0,0,Sonnig,13,13,0,
,2021-05-31 10:00:00,0,0,0,Sonnig,14,14,0,
,2021-05-31 11:00:00,0,0,0,Sonnig,16,15,0,
,2021-05-31 12:00:00,0,0,0,Sonnig,17,17,0,
,2021-05-31 13:00:00,0,0,0,Sonnig,17,17,0,
,2021-05-31 14:00:00,0,0,0,Leicht bewölkt,18,18,0,
,2021-05-31 15:00:00,0,0,0,Leicht bewölkt,18,18,0,
,2021-05-31 16:00:00,0,0,0,Leicht bewölkt,17,17,0,
,2021-05-31 17:00:00,0,0,0,Leicht bewölkt,16,15,0,
,2021-05-31 18:00:00,0,0,0,Leicht bewölkt,15,14,0,
,2021-05-31 19:00:00,0,0,0,Leicht bewölkt,14,12,0,
,2021-05-31 20:00:00,0,0,0,Leicht bewölkt,12,10,0,
,2021-05-31 21:00:00,0,0,0,Leicht bewölkt,11,9,0,
,2021-05-31 22:00:00,0,0,0,Leicht bewölkt,10,9,0,
,2021-05-31 23:00:00,0,0,0,Sonnig,10,9,0,
,2021-06-01 00:00:00,0,0,0,Sonnig,10,9,0,
,2021-06-01 01:00:00,0,0,0,Sonnig,9,9,0,
,2021-06-01 02:00:00,0,0,0,Sonnig,9,8,0,
,2021-06-01 03:00:00,0,0,0,Sonnig,8,8,0,
,2021-06-01 04:00:00,0,0,0,Sonnig,9,9,0,
,2021-06-01 05:00:00,0,0,0,Sonnig,10,10,0,
,2021-06-01 06:00:00,0,0,0,Sonnig,11,11,0,
,2021-06-01 07:00:00,0,0,0,Sonnig,13,13,0,
,2021-06-01 08:00:00,0,0,0,Sonnig,15,15,0,
,2021-06-01 09:00:00,0,0,0,Sonnig,17,17,0,
,2021-06-01 10:00:00,0,0,0,Sonnig,18,18,0,
,2021-06-01 11:00:00,0,0,0,Sonnig,19,19,0,
,2021-06-01 12:00:00,0,0,0,Sonnig,20,20,0,
,2021-06-01 13:00:00,0,0,0,Sonnig,20,20,0,
,2021-06-01 14:00:00,0,0,0,Leicht bewölkt,20,20,0,
,2021-06-01 15:00:00,0,0,0,Leicht bewölkt,20,20,0,
,2021-06-01 16:00:00,0,0,0,Leicht bewölkt,19,19,0,
,2021-06-01 17:00:00,0,0,0,Leicht bewölkt,18,18,0,
,2021-06-01 18:00:00,0,0,0,Leicht bewölkt,17,17,0,
,2021-06-01 19:00:00,0,0,0,Leicht bewölkt,15,15,0,
,2021-06-01 20:00:00,0,0,0,Sonnig,14,14,0,
,2021-06-01 21:00:00,0,0,0,Sonnig,13,13,0,
,2021-06-01 22:00:00,0,0,0,Sonnig,12,12,0,
,2021-06-01 23:00:00,0,0,0,Sonnig,10,10,0,
,2021-06-02 00:00:00,0,0,0,Sonnig,9,9,0,
,2021-06-02 01:00:00,0,0,0,Sonnig,9,8,0,
,2021-06-02 02:00:00,0,0,0,Leicht bewölkt,8,8,0,
,2021-06-02 03:00:00,0,0,0,Leicht bewölkt,7,7,0,
,2021-06-02 04:00:00,0,0,0,Leicht bewölkt,9,8,0,
,2021-06-02 05:00:00,0,0,0,Leicht bewölkt,10,10,0,
,2021-06-02 06:00:00,0,0,0,Leicht bewölkt,12,11,0,
,2021-06-02 07:00:00,0,0,0,Leicht bewölkt,14,13,0,
,2021-06-02 08:00:00,0,0,0,Leicht bewölkt,16,15,0,
,2021-06-02 09:00:00,0,0,0,Leicht bewölkt,18,18,0,
,2021-06-02 10:00:00,0,0,0,Leicht bewölkt,19,19,0,
,2021-06-02 11:00:00,0,0,0,Leicht bewölkt,20,20,0,
,2021-06-02 12:00:00,0,0,0,Leicht bewölkt,21,21,0,
,2021-06-02 13:00:00,0,0,0,Leicht bewölkt,21,21,0,
,2021-06-02 14:00:00,0,0,0,Leicht bewölkt,22,22,0,
,2021-06-02 15:00:00,606,320,286,Leicht bewölkt,22,22,0,
,2021-06-02 16:00:00,963,465,498,Leicht bewölkt,21,21,0,
,2021-06-02 17:00:00,1018,502,516,Leicht bewölkt,20,20,0,
,2021-06-02 18:00:00,923,422,501,Leicht bewölkt,19,19,0,
,2021-06-02 19:00:00,687,314,373,Leicht bewölkt,18,18,0,
,2021-06-02 20:00:00,575,292,283,Leicht bewölkt,16,16,0,
,2021-06-02 21:00:00,381,160,221,Leicht bewölkt,15,15,0,
,2021-06-02 22:00:00,271,105,166,Leicht bewölkt,14,14,0,
,2021-06-02 23:00:00,181,71,110,Leicht bewölkt,13,13,0,
,2021-06-03 00:00:00,98,33,65,Leicht bewölkt,12,12,0,
,2021-06-03 01:00:00,73,33,40,Leicht bewölkt,12,12,0,
,2021-06-03 02:00:00,52,16,36,Leicht bewölkt,11,11,0,
,2021-06-03 03:00:00,28,10,18,Leicht bewölkt,11,11,0,
,2021-06-03 04:00:00,15,9,6,Leicht bewölkt,12,12,0,
,2021-06-03 05:00:00,25,14,11,Leicht bewölkt,13,13,0,
,2021-06-03 06:00:00,71,53,18,Leicht bewölkt,14,14,0,
,2021-06-03 07:00:00,100,76,24,Leicht bewölkt,16,16,0,
,2021-06-03 08:00:00,186,111,75,Leicht bewölkt,18,18,0,
,2021-06-03 09:00:00,257,146,111,Leicht bewölkt,20,20,0,
,2021-06-03 10:00:00,340,169,171,Leicht bewölkt,21,21,0,
,2021-06-03 11:00:00,515,266,249,Leicht bewölkt,22,22,0,
,2021-06-03 12:00:00,545,286,259,Leicht bewölkt,23,25,0,
,2021-06-03 13:00:00,582,299,283,Leicht bewölkt,23,25,0,
,2021-06-03 14:00:00,644,319,325,Leicht bewölkt,24,25,0,
,2021-06-03 15:00:00,710,368,342,Leicht bewölkt,24,25,0,
,2021-06-03 16:00:00,733,303,430,Leicht bewölkt,23,24,0,
,2021-06-03 17:00:00,737,354,383,Leicht bewölkt,22,22,0,
,2021-06-03 18:00:00,706,366,340,Leicht bewölkt,21,21,0,
,2021-06-03 19:00:00,630,330,300,Leicht bewölkt,19,19,0,
,2021-06-03 20:00:00,431,190,241,Stellenweiser Regenfall,18,18,0,
,2021-06-03 21:00:00,355,146,209,Stellenweiser Regenfall,16,16,0,
,2021-06-03 22:00:00,283,90,193,Stellenweiser Regenfall,16,16,0,
,2021-06-03 23:00:00,148,37,111,Leichter Regenschauer,15,15,1,
,2021-06-04 00:00:00,88,34,54,Leichter Regenschauer,15,15,2,
,2021-06-04 01:00:00,68,28,40,Leichter Regenschauer,15,15,1,
,2021-06-04 02:00:00,27,9,18,Mäßiger bis starker Regenschauer,14,14,0.7,
,2021-06-04 03:00:00,17,4,13,Mäßiger bis starker Regenschauer,14,14,0.9,
,2021-06-04 04:00:00,10,8,2,Mäßiger bis starker Regenschauer,14,15,0.5,
,2021-06-04 05:00:00,45,32,13,Leichter Regenschauer,15,15,1,
,2021-06-04 06:00:00,150,104,46,Leichter Regenschauer,15,15,1.4,
,2021-06-04 07:00:00,314,188,126,Leichter Regenschauer,15,16,0.7,
,2021-06-04 08:00:00,471,277,194,Mäßiger bis starker Regenschauer,16,16,1.3,
,2021-06-04 09:00:00,651,403,248,Mäßiger bis starker Regenschauer,16,16,1.8,
,2021-06-04 10:00:00,718,420,298,Mäßiger bis starker Regenschauer,17,17,0.9,
,2021-06-04 11:00:00,680,324,356,Mäßiger Regenfall,17,17,1.7,
,2021-06-04 12:00:00,653,260,393,Mäßiger Regenfall,18,18,2.3,
,2021-06-04 13:00:00,666,321,345,Mäßiger Regenfall,19,19,1.1,
,2021-06-04 14:00:00,707,361,346,Teilweise mäßiger Regenfall,19,19,0.8,
,2021-06-04 15:00:00,716,373,343,Teilweise mäßiger Regenfall,20,20,1,
,2021-06-04 16:00:00,798,353,445,Teilweise mäßiger Regenfall,20,20,0.5,
,2021-06-04 17:00:00,859,401,458,Leichter Regenschauer,19,19,0.1,
,2021-06-04 18:00:00,786,347,439,Leichter Regenschauer,19,19,0.1,
,2021-06-04 19:00:00,618,290,328,Leichter Regenschauer,18,18,0,
,2021-06-04 20:00:00,387,173,214,Leicht bewölkt,17,17,0,
,2021-06-04 21:00:00,319,153,166,Leicht bewölkt,16,16,0,
,2021-06-04 22:00:00,259,98,161,Leicht bewölkt,15,15,0,
,2021-06-04 23:00:00,138,43,95,Leichter Regenschauer,14,15,0.2,
,2021-06-05 00:00:00,135,51,84,Leichter Regenschauer,14,14,0.3,
,2021-06-05 01:00:00,72,17,55,Leichter Regenschauer,13,14,0.2,
,2021-06-05 02:00:00,37,14,23,Leichter Nebel,13,13,0.2,
,2021-06-05 03:00:00,18,9,9,Leichter Nebel,13,13,0.3,
,2021-06-05 04:00:00,31,13,18,Leichter Nebel,13,13,0.2,
,2021-06-05 05:00:00,25,13,12,Leichter Regenschauer,14,14,0.3,
,2021-06-05 06:00:00,57,40,17,Leichter Regenschauer,15,15,0.4,
,2021-06-05 07:00:00,73,39,34,Leichter Regenschauer,16,16,0.2,
,2021-06-05 08:00:00,191,119,72,Stellenweiser Regenfall,18,18,0.2,
,2021-06-05 09:00:00,341,195,146,Stellenweiser Regenfall,19,19,0.2,
,2021-06-05 10:00:00,462,256,206,Stellenweiser Regenfall,19,19,0.1,
,2021-06-05 11:00:00,546,301,245,Leichter Regenschauer,20,20,0.2,
,2021-06-05 12:00:00,530,282,248,Leichter Regenschauer,20,20,0.3,
,2021-06-05 13:00:00,477,235,242,Leichter Regenschauer,18,18,0.1,
,2021-06-05 14:00:00,473,225,248,Leichter Regenschauer,17,16,0.7,
,2021-06-05 15:00:00,372,162,210,Leichter Regenschauer,16,15,1,
,2021-06-05 16:00:00,335,144,191,Leichter Regenschauer,14,14,0.5,
,2021-06-05 17:00:00,363,163,200,Mäßiger bis starker Regenschauer,13,12,0.6,
,2021-06-05 18:00:00,354,169,185,Mäßiger bis starker Regenschauer,11,11,0.8,
,2021-06-05 19:00:00,325,133,192,Mäßiger bis starker Regenschauer,10,10,0.4,
,2021-06-05 20:00:00,264,136,128,Leichter Regenfall,8,8,0.3,
,2021-06-05 21:00:00,199,89,110,Leichter Regenfall,7,7,0.4,
,2021-06-05 22:00:00,170,73,97,Leichter Regenfall,9,9,0.2,
,2021-06-05 23:00:00,109,35,74,Leichter Regenfall,11,11,0.1,
,2021-06-06 00:00:00,88,34,54,Leichter Regenfall,13,13,0.2,
,2021-06-06 01:00:00,46,22,24,Leichter Regenfall,13,13,0.1,
,2021-06-06 02:00:00,50,18,32,Leichter Nebel,13,13,0.1,
,2021-06-06 03:00:00,23,7,16,Leichter Nebel,13,13,0.1,
,2021-06-06 04:00:00,21,9,12,Leichter Nebel,13,13,0.1,
,2021-06-06 05:00:00,6,3,3,Nieselregen,13,13,0.1,
,2021-06-06 06:00:00,39,22,17,Nieselregen,13,13,0.2,
,2021-06-06 07:00:00,27,15,12,Nieselregen,14,14,0.1,
,2021-06-06 08:00:00,64,26,38,Nieselregen,14,14,0.1,
,2021-06-06 09:00:00,147,82,65,Nieselregen,14,14,0.1,
,2021-06-06 10:00:00,198,84,114,Nieselregen,14,14,0.1,
,2021-06-06 11:00:00,226,133,93,Nieselregen,15,15,0,
,2021-06-06 12:00:00,182,80,102,Nieselregen,15,15,0,
,2021-06-06 13:00:00,155,80,75,Nieselregen,15,15,0,
,2021-06-06 14:00:00,178,90,88,Bedeckt,16,16,0,
,2021-06-06 15:00:00,218,97,121,Bedeckt,16,16,0,
,2021-06-06 16:00:00,207,103,104,Bedeckt,16,16,0,
,2021-06-06 17:00:00,178,79,99,Bewölkt,15,15,0,
,2021-06-06 18:00:00,139,71,68,Bewölkt,15,15,0,
,2021-06-06 19:00:00,131,54,77,Bewölkt,15,15,0,
,2021-06-06 20:00:00,101,45,56,Leicht bewölkt,14,14,0.1,
,2021-06-06 21:00:00,76,37,39,Leicht bewölkt,14,14,0.1,
,2021-06-06 22:00:00,44,24,20,Leicht bewölkt,14,14,0,
,2021-06-06 23:00:00,37,14,23,Leichter Nebel,14,14,0,
,2021-06-07 00:00:00,30,13,17,Leichter Nebel,14,14,0,
,2021-06-07 01:00:00,11,6,5,Leichter Nebel,14,14,0,
,2021-06-07 02:00:00,6,3,3,Leichter Nebel,13,14,0.3,
,2021-06-07 03:00:00,4,3,1,Leichter Nebel,13,14,0.4,
,2021-06-07 04:00:00,6,5,1,Leichter Nebel,13,14,0.2,
,2021-06-07 05:00:00,35,17,18,Leichter Regenfall,13,14,0.2,
,2021-06-07 06:00:00,137,81,56,Leichter Regenfall,13,14,0.2,
,2021-06-07 07:00:00,808,529,279,Leichter Regenfall,13,14,0.1,
,2021-06-07 08:00:00,623,328,295,Nebel,13,14,0.1,
,2021-06-07 09:00:00,485,282,203,Nebel,14,14,0.2,
,2021-06-07 10:00:00,317,174,143,Nebel,14,14,0.1,
,2021-06-07 11:00:00,445,232,213,Nieselregen,14,14,0.1,
,2021-06-07 12:00:00,590,285,305,Nieselregen,14,14,0.1,
,2021-06-07 13:00:00,815,340,475,Nieselregen,15,15,0,
,2021-06-07 14:00:00,643,292,351,Leichter Nebel,15,15,0,
,2021-06-07 15:00:00,774,376,398,Leichter Nebel,16,16,0,
,2021-06-07 16:00:00,713,305,408,Leichter Nebel,16,16,0,
,2021-06-07 17:00:00,633,275,358,Stellenweiser Regenfall,16,16,0,
,2021-06-07 18:00:00,568,240,328,Stellenweiser Regenfall,16,16,0,
,2021-06-07 19:00:00,327,139,188,Stellenweiser Regenfall,16,16,0,
,2021-06-07 20:00:00,234,102,132,Bedeckt,15,15,0.1,
,2021-06-07 21:00:00,162,74,88,Bedeckt,15,15,0.1,
,2021-06-07 22:00:00,96,43,53,Bedeckt,14,14,0.1,
,2021-06-07 23:00:00,55,25,30,Leichter Nebel,13,13,0,
,2021-06-08 00:00:00,30,14,16,Leichter Nebel,13,13,0,
,2021-06-08 01:00:00,13,9,4,Leichter Nebel,13,13,0,
,2021-06-08 02:00:00,6,4,2,Leichter Nebel,13,13,0,
,2021-06-08 03:00:00,2,1,1,Leichter Nebel,13,13,0,
,2021-06-08 04:00:00,6,3,3,Leichter Nebel,13,14,0,
,2021-06-08 05:00:00,52,33,19,Leichter Nebel,14,14,0,
,2021-06-08 06:00:00,183,104,79,Leichter Nebel,14,14,0,
,2021-06-08 07:00:00,948,605,343,Leichter Nebel,15,15,0,
,2021-06-08 08:00:00,681,376,305,Leichter Nebel,16,16,0,
,2021-06-08 09:00:00,595,330,265,Leichter Nebel,16,16,0,
,2021-06-08 10:00:00,457,248,209,Leichter Nebel,17,17,0,
,2021-06-08 11:00:00,598,314,284,Leichter Regenschauer,18,18,0.5,
,2021-06-08 12:00:00,665,309,356,Leichter Regenschauer,18,18,0.7,
,2021-06-08 13:00:00,923,439,484,Leichter Regenschauer,18,18,0.3,
,2021-06-08 14:00:00,764,346,418,Leichter Regenschauer,19,19,1.2,
,2021-06-08 15:00:00,862,413,449,Leichter Regenschauer,19,19,1.6,
,2021-06-08 16:00:00,869,448,421,Leichter Regenschauer,18,18,0.8,
,2021-06-08 17:00:00,971,418,553,Mäßiger bis starker Regenschauer,18,18,0.7,
,2021-06-08 18:00:00,805,361,444,Mäßiger bis starker Regenschauer,17,17,1,
,2021-06-08 19:00:00,562,253,309,Mäßiger bis starker Regenschauer,16,17,0.5,
,2021-06-08 20:00:00,267,95,172,Leichter Regenschauer,15,16,0.6,
,2021-06-08 21:00:00,197,90,107,Leichter Regenschauer,14,15,0.8,
,2021-06-08 22:00:00,102,38,64,Leichter Regenschauer,14,14,0.4,
,2021-06-08 23:00:00,71,25,46,Leichter Regenschauer,13,14,0.4,
,2021-06-09 00:00:00,40,15,25,Leichter Regenschauer,13,13,0.9,
,2021-06-09 01:00:00,15,11,4,Leichter Regenschauer,13,13,0.4,
,2021-06-09 02:00:00,9,5,4,Leichter Regenschauer,13,13,0.3,
,2021-06-09 03:00:00,8,8,0,Leichter Regenschauer,12,12,0.4,
,2021-06-09 04:00:00,7,4,3,Leichter Regenschauer,13,13,0.2,
,2021-06-09 05:00:00,48,33,15,Leichter Regenschauer,14,14,0.4,
,2021-06-09 06:00:00,179,108,71,Leichter Regenschauer,14,14,0.5,
,2021-06-09 07:00:00,951,597,354,Leichter Regenschauer,16,16,0.2,
,2021-06-09 08:00:00,704,380,324,Stellenweiser leichter Regenfall,17,17,0.2,
,2021-06-09 09:00:00,645,386,259,Stellenweiser leichter Regenfall,18,18,0.3,
,2021-06-09 10:00:00,481,245,236,Stellenweiser leichter Regenfall,19,19,0.1,
,2021-06-09 11:00:00,580,282,298,Stellenweiser Regenfall,20,20,0,
,2021-06-09 12:00:00,745,333,412,Stellenweiser Regenfall,20,20,0,
,2021-06-09 13:00:00,1006,507,499,Stellenweiser Regenfall,20,20,0,
,2021-06-09 14:00:00,797,392,405,Stellenweise Gewitter und Niederschläge,20,20,0.9,
,2021-06-09 15:00:00,821,354,467,Stellenweise Gewitter und Niederschläge,20,20,1.2,
,2021-06-09 16:00:00,739,374,365,Stellenweise Gewitter und Niederschläge,20,20,0.6,
,2021-06-09 17:00:00,766,376,390,Mäßiger bis starker Regenschauer,19,19,1.6,
,2021-06-09 18:00:00,744,330,414,Mäßiger bis starker Regenschauer,18,18,2.1,
,2021-06-09 19:00:00,548,248,300,Mäßiger bis starker Regenschauer,17,17,1.1,
,2021-06-09 20:00:00,382,159,223,Mäßiger bis starker Regenschauer,15,16,0.6,
,2021-06-09 21:00:00,274,114,160,Mäßiger bis starker Regenschauer,14,15,0.8,
,2021-06-09 22:00:00,202,92,110,Mäßiger bis starker Regenschauer,14,14,0.4,
,2021-06-09 23:00:00,117,44,73,Leichter Regenschauer,13,13,0.3,
,2021-06-10 00:00:00,74,21,53,Leichter Regenschauer,13,13,0.6,
,2021-06-10 01:00:00,19,9,10,Leichter Regenschauer,12,12,0.3,
,2021-06-10 02:00:00,20,15,5,Stellenweiser Regenfall,12,12,0.1,
,2021-06-10 03:00:00,16,7,9,Stellenweiser Regenfall,12,12,0.1,
,2021-06-10 04:00:00,8,6,2,Stellenweiser Regenfall,12,12,0.1,
,2021-06-10 05:00:00,55,31,24,Leicht bewölkt,13,13,0,
,2021-06-10 06:00:00,188,108,80,Leicht bewölkt,14,14,0,
,2021-06-10 07:00:00,986,608,378,Leicht bewölkt,16,16,0,
,2021-06-10 08:00:00,758,417,341,Leicht bewölkt,17,17,0,
,2021-06-10 09:00:00,666,403,263,Leicht bewölkt,19,19,0,
,2021-06-10 10:00:00,478,280,198,Leicht bewölkt,20,20,0,
,2021-06-10 11:00:00,701,350,351,Leicht bewölkt,20,20,0.3,
,2021-06-10 12:00:00,779,364,415,Leicht bewölkt,21,21,0.4,
,2021-06-10 13:00:00,1116,519,597,Leicht bewölkt,21,21,0.2,
,2021-06-10 14:00:00,924,482,442,Stellenweiser Regenfall,21,21,0.8,
,2021-06-10 15:00:00,909,448,461,Stellenweiser Regenfall,21,21,1,
,2021-06-10 16:00:00,1084,540,544,Stellenweiser Regenfall,20,20,0.5,
,2021-06-10 17:00:00,1032,477,555,Mäßiger bis starker Regenschauer,20,20,1,
,2021-06-10 18:00:00,940,423,517,Mäßiger bis starker Regenschauer,19,19,1.4,
,2021-06-10 19:00:00,706,312,394,Mäßiger bis starker Regenschauer,18,18,0.7,
,2021-06-10 20:00:00,482,229,253,Mäßiger bis starker Regenschauer,17,17,0.6,
,2021-06-10 21:00:00,364,148,216,Mäßiger bis starker Regenschauer,16,16,0.8,
,2021-06-10 22:00:00,235,75,160,Mäßiger bis starker Regenschauer,15,15,0.4,
,2021-06-10 23:00:00,171,64,107,Stellenweiser Regenfall,14,14,0.1,
,2021-06-11 00:00:00,74,27,47,Stellenweiser Regenfall,13,13,0.2,
,2021-06-11 01:00:00,77,42,35,Stellenweiser Regenfall,13,13,0.1,
,2021-06-11 02:00:00,25,10,15,Stellenweiser Regenfall,12,12,0,
,2021-06-11 03:00:00,14,3,11,Stellenweiser Regenfall,12,12,0,
,2021-06-11 04:00:00,17,13,4,Stellenweiser Regenfall,13,13,0,
,2021-06-11 05:00:00,53,32,21,Leicht bewölkt,14,14,0,
,2021-06-11 06:00:00,189,119,70,Leicht bewölkt,15,15,0,
,2021-06-11 07:00:00,989,640,349,Leicht bewölkt,16,16,0,
,2021-06-11 08:00:00,800,460,340,Leicht bewölkt,18,18,0,
,2021-06-11 09:00:00,789,458,331,Leicht bewölkt,19,19,0,
,2021-06-11 10:00:00,661,372,289,Leicht bewölkt,20,20,0,
,2021-06-11 11:00:00,772,392,380,Leicht bewölkt,21,21,0,
,2021-06-11 12:00:00,951,463,488,Leicht bewölkt,23,24,0,
,2021-06-11 13:00:00,1205,519,686,Leicht bewölkt,23,24,0,
,2021-06-11 14:00:00,909,432,477,Leicht bewölkt,23,25,0,
,2021-06-11 15:00:00,974,507,467,Leicht bewölkt,23,25,0,
,2021-06-11 16:00:00,968,488,480,Leicht bewölkt,23,25,0,
,2021-06-11 17:00:00,924,444,480,Leicht bewölkt,22,24,0.1,
,2021-06-11 18:00:00,866,433,433,Leicht bewölkt,21,21,0.1,
,2021-06-11 19:00:00,829,455,374,Leicht bewölkt,20,20,0.1,
,2021-06-11 20:00:00,641,323,318,Stellenweiser Regenfall,19,19,0,
,2021-06-11 21:00:00,437,167,270,Stellenweiser Regenfall,18,18,0,
,2021-06-11 22:00:00,290,99,191,Stellenweiser Regenfall,16,16,0,
,2021-06-11 23:00:00,321,109,212,Leicht bewölkt,15,15,0,
,2021-06-12 00:00:00,225,85,140,Leicht bewölkt,14,14,0,
,2021-06-12 01:00:00,143,59,84,Leicht bewölkt,13,13,0,
,2021-06-12 02:00:00,93,42,51,Leicht bewölkt,13,13,0,
,2021-06-12 03:00:00,64,21,43,Leicht bewölkt,12,12,0,
,2021-06-12 04:00:00,40,17,23,Leicht bewölkt,13,13,0,
,2021-06-12 05:00:00,36,21,15,Leicht bewölkt,14,14,0,
,2021-06-12 06:00:00,66,44,22,Leicht bewölkt,15,15,0,
,2021-06-12 07:00:00,126,70,56,Leicht bewölkt,17,17,0,
,2021-06-12 08:00:00,304,172,132,Leicht bewölkt,18,18,0,
,2021-06-12 09:00:00,515,289,226,Leicht bewölkt,20,20,0,
,2021-06-12 10:00:00,669,391,278,Leicht bewölkt,21,21,0,
,2021-06-12 11:00:00,841,440,401,Leicht bewölkt,22,24,0,
,2021-06-12 12:00:00,734,370,364,Leicht bewölkt,23,25,0,
,2021-06-12 13:00:00,822,409,413,Leicht bewölkt,24,25,0,
,2021-06-12 14:00:00,832,417,415,Leicht bewölkt,24,25,0.1,
,2021-06-12 15:00:00,820,375,445,Leicht bewölkt,24,25,0.1,
,2021-06-12 16:00:00,674,359,315,Leicht bewölkt,23,24,0,
,2021-06-12 17:00:00,741,378,363,Stellenweiser Regenfall,22,23,0,
,2021-06-12 18:00:00,743,347,396,Stellenweiser Regenfall,21,21,0,
,2021-06-12 19:00:00,643,317,326,Stellenweiser Regenfall,20,20,0,
,2021-06-12 20:00:00,510,265,245,Leicht bewölkt,19,19,0.1,
,2021-06-12 21:00:00,429,212,217,Leicht bewölkt,18,18,0.1,
,2021-06-12 22:00:00,305,114,191,Leicht bewölkt,17,17,0.1,
,2021-06-12 23:00:00,252,84,168,Leichter Regenschauer,16,16,0.2,
,2021-06-13 00:00:00,245,91,154,Leichter Regenschauer,16,16,0.4,
,2021-06-13 01:00:00,134,41,93,Leichter Regenschauer,15,15,0.2,
,2021-06-13 02:00:00,67,25,42,Leichter Regenschauer,15,15,0.1,
,2021-06-13 03:00:00,62,28,34,Leichter Regenschauer,15,15,0.1,
,2021-06-13 04:00:00,29,15,14,Leichter Regenschauer,15,15,0,
,2021-06-13 05:00:00,41,17,24,Bedeckt,15,15,0,
,2021-06-13 06:00:00,57,38,19,Bedeckt,16,16,0,
,2021-06-13 07:00:00,72,43,29,Bedeckt,16,16,0,
,2021-06-13 08:00:00,144,82,62,Bewölkt,17,17,0,
,2021-06-13 09:00:00,318,185,133,Bewölkt,18,18,0,
,2021-06-13 10:00:00,440,233,207,Bewölkt,19,19,0,
,2021-06-13 11:00:00,571,262,309,Leicht bewölkt,20,20,0,
,2021-06-13 12:00:00,570,276,294,Leicht bewölkt,21,21,0,
,2021-06-13 13:00:00,729,349,380,Leicht bewölkt,21,21,0,
,2021-06-13 14:00:00,678,303,375,Leicht bewölkt,21,21,0,
,2021-06-13 15:00:00,618,321,297,Leicht bewölkt,22,22,0,
,2021-06-13 16:00:00,643,318,325,Leicht bewölkt,21,21,0,
,2021-06-13 17:00:00,662,314,348,Sonnig,20,20,0,
,2021-06-13 18:00:00,691,339,352,Sonnig,19,19,0,
,2021-06-13 19:00:00,618,292,326,Sonnig,18,18,0,
,2021-06-13 20:00:00,439,195,244,Leicht bewölkt,17,17,0,
,2021-06-13 21:00:00,355,153,202,Leicht bewölkt,16,16,0,
,2021-06-13 22:00:00,204,57,147,Leicht bewölkt,15,14,0,
,2021-06-13 23:00:00,95,40,55,Sonnig,13,13,0,
,2021-06-14 00:00:00,54,23,31,Sonnig,12,12,0,
,2021-06-14 01:00:00,20,10,10,Sonnig,12,11,0,
,2021-06-14 02:00:00,7,3,4,Sonnig,11,11,0,
,2021-06-14 03:00:00,2,0,2,Sonnig,11,10,0,
,2021-06-14 04:00:00,10,7,3,Sonnig,12,12,0,
,2021-06-14 05:00:00,52,33,19,Sonnig,13,13,0,
,2021-06-14 06:00:00,221,127,94,Sonnig,14,14,0,
,2021-06-14 07:00:00,1088,686,402,Sonnig,16,16,0,
,2021-06-14 08:00:00,893,505,388,Sonnig,18,18,0,
,2021-06-14 09:00:00,697,395,302,Sonnig,19,19,0,
,2021-06-14 10:00:00,569,321,248,Sonnig,21,21,0,
,2021-06-14 11:00:00,688,338,350,Sonnig,22,22,0,
,2021-06-14 12:00:00,869,408,461,Sonnig,23,24,0,
,2021-06-14 13:00:00,1191,500,691,Sonnig,23,24,0,
,2021-06-14 14:00:00,928,421,507,Sonnig,24,25,0,
,2021-06-14 15:00:00,989,451,538,Sonnig,24,26,0,
,2021-06-14 16:00:00,1063,536,527,Sonnig,23,24,0,
,2021-06-14 17:00:00,1098,525,573,Sonnig,23,23,0,
,2021-06-14 18:00:00,1043,489,554,Sonnig,22,22,0,
,2021-06-14 19:00:00,687,310,377,Sonnig,21,21,0,
,2021-06-14 20:00:00,635,307,328,Leicht bewölkt,19,19,0,
,2021-06-14 21:00:00,452,166,286,Leicht bewölkt,18,18,0,
,2021-06-14 22:00:00,253,84,169,Leicht bewölkt,17,17,0,
,2021-06-14 23:00:00,137,58,79,Sonnig,15,15,0,
,2021-06-15 00:00:00,53,23,30,Sonnig,14,14,0,
,2021-06-15 01:00:00,28,17,11,Sonnig,13,13,0,
,2021-06-15 02:00:00,24,8,16,Leicht bewölkt,12,12,0,
,2021-06-15 03:00:00,6,1,5,Leicht bewölkt,12,12,0,
,2021-06-15 04:00:00,5,3,2,Leicht bewölkt,13,13,0,
,2021-06-15 05:00:00,61,33,28,Leicht bewölkt,14,14,0,
,2021-06-15 06:00:00,253,143,110,Leicht bewölkt,15,15,0,
,2021-06-15 07:00:00,1144,733,411,Leicht bewölkt,17,17,0,
,2021-06-15 08:00:00,940,523,417,Leicht bewölkt,18,18,0,
,2021-06-15 09:00:00,816,461,355,Leicht bewölkt,20,20,0,
,2021-06-15 10:00:00,620,338,282,Leicht bewölkt,22,22,0,
,2021-06-15 11:00:00,786,434,352,Sonnig,23,24,0,
,2021-06-15 12:00:00,865,356,509,Sonnig,24,25,0,
,2021-06-15 13:00:00,1135,507,628,Sonnig,24,25,0,
,2021-06-15 14:00:00,862,425,437,Sonnig,24,26,0,
,2021-06-15 15:00:00,1046,492,554,Sonnig,25,26,0,
,2021-06-15 16:00:00,1085,534,551,Sonnig,24,24,0,
,2021-06-15 17:00:00,1216,593,623,Leicht bewölkt,23,23,0,
,2021-06-15 18:00:00,1099,513,586,Leicht bewölkt,22,22,0,
,2021-06-15 19:00:00,883,426,457,Leicht bewölkt,21,21,0,
,2021-06-15 20:00:00,833,405,428,Leicht bewölkt,20,20,0,
,2021-06-15 21:00:00,405,167,238,Leicht bewölkt,19,19,0,
,2021-06-15 22:00:00,212,69,143,Leicht bewölkt,17,18,0,
,2021-06-15 23:00:00,552,197,355,Leicht bewölkt,16,17,0,
,2021-06-16 00:00:00,141,50,91,Leicht bewölkt,15,16,0,
,2021-06-16 01:00:00,61,21,40,Leicht bewölkt,15,15,0,
,2021-06-16 02:00:00,31,12,19,Leicht bewölkt,14,14,0,
,2021-06-16 03:00:00,21,7,14,Leicht bewölkt,13,14,0,
,2021-06-16 04:00:00,22,6,16,Leicht bewölkt,14,15,0,
,2021-06-16 05:00:00,67,38,29,Leicht bewölkt,15,16,0,
,2021-06-16 06:00:00,240,148,92,Leicht bewölkt,17,17,0,
,2021-06-16 07:00:00,1120,717,403,Leicht bewölkt,18,18,0,
,2021-06-16 08:00:00,841,460,381,Leicht bewölkt,20,20,0,
,2021-06-16 09:00:00,794,474,320,Leicht bewölkt,22,23,0,
,2021-06-16 10:00:00,602,322,280,Leicht bewölkt,24,24,0,
,2021-06-16 11:00:00,684,312,372,Leicht bewölkt,25,26,0,
,2021-06-16 12:00:00,885,421,464,Leicht bewölkt,26,27,0,
,2021-06-16 13:00:00,1172,547,625,Leicht bewölkt,26,27,0,
,2021-06-16 14:00:00,854,375,479,Sonnig,27,27,0,
,2021-06-16 15:00:00,1050,457,593,Sonnig,27,28,0,
,2021-06-16 16:00:00,1097,574,523,Sonnig,26,27,0,
,2021-06-16 17:00:00,1220,609,611,Sonnig,25,26,0,
,2021-06-16 18:00:00,1069,509,560,Sonnig,24,26,0,
,2021-06-16 19:00:00,813,400,413,Sonnig,23,24,0,
,2021-06-16 20:00:00,651,278,373,Sonnig,21,21,0,
,2021-06-16 21:00:00,482,176,306,Sonnig,20,20,0,
,2021-06-16 22:00:00,290,110,180,Sonnig,19,19,0,
,2021-06-16 23:00:00,198,67,131,Leicht bewölkt,18,18,0,
,2021-06-17 00:00:00,72,18,54,Leicht bewölkt,18,18,0,
,2021-06-17 01:00:00,44,13,31,Leicht bewölkt,17,17,0,
,2021-06-17 02:00:00,23,8,15,Leicht bewölkt,17,17,0,
,2021-06-17 03:00:00,6,0,6,Leicht bewölkt,17,17,0,
,2021-06-17 04:00:00,12,6,6,Leicht bewölkt,17,17,0,
,2021-06-17 05:00:00,71,39,32,Sonnig,18,18,0,
,2021-06-17 06:00:00,220,128,92,Sonnig,19,19,0,
,2021-06-17 07:00:00,1198,782,416,Sonnig,21,21,0,
,2021-06-17 08:00:00,898,496,402,Leicht bewölkt,23,23,0,
,2021-06-17 09:00:00,787,470,317,Leicht bewölkt,24,25,0,
,2021-06-17 10:00:00,611,314,297,Leicht bewölkt,25,26,0,
,2021-06-17 11:00:00,664,319,345,Leicht bewölkt,26,27,0,
,2021-06-17 12:00:00,853,406,447,Leicht bewölkt,28,28,0,
,2021-06-17 13:00:00,1088,478,610,Leicht bewölkt,28,29,0,
,2021-06-17 14:00:00,895,421,474,Leicht bewölkt,28,29,0,
,2021-06-17 15:00:00,1009,431,578,Leicht bewölkt,28,29,0,
,2021-06-17 16:00:00,1084,533,551,Leicht bewölkt,28,29,0,
,2021-06-17 17:00:00,1133,536,597,Leicht bewölkt,27,29,0,
,2021-06-17 18:00:00,1143,556,587,Leicht bewölkt,27,29,0,
,2021-06-17 19:00:00,897,424,473,Leicht bewölkt,26,28,0,
,2021-06-17 20:00:00,709,346,363,Leicht bewölkt,25,27,0,
,2021-06-17 21:00:00,547,220,327,Leicht bewölkt,24,26,0,
,2021-06-17 22:00:00,409,154,255,Leicht bewölkt,22,22,0,
,2021-06-17 23:00:00,212,79,133,Leicht bewölkt,20,20,0,
,2021-06-18 00:00:00,121,51,70,Leicht bewölkt,19,19,0.1,
,2021-06-18 01:00:00,69,28,41,Leicht bewölkt,18,18,0,
,2021-06-18 02:00:00,19,8,11,Stellenweiser Regenfall,17,17,0.2,
,2021-06-18 03:00:00,15,3,12,Stellenweiser Regenfall,16,16,0.2,
,2021-06-18 04:00:00,20,9,11,Stellenweiser Regenfall,17,17,0.1,
,2021-06-18 05:00:00,64,37,27,Teilweise mäßiger Regenfall,18,18,0.3,
,2021-06-18 06:00:00,207,127,80,Teilweise mäßiger Regenfall,18,18,0.4,
,2021-06-18 07:00:00,1062,668,394,Teilweise mäßiger Regenfall,20,20,0.2,
,2021-06-18 08:00:00,906,519,387,Stellenweiser Regenfall,22,22,0.1,
,2021-06-18 09:00:00,839,475,364,Stellenweiser Regenfall,23,24,0.2,
,2021-06-18 10:00:00,654,344,310,Stellenweiser Regenfall,24,25,0.1,
,2021-06-18 11:00:00,807,368,439,Leicht bewölkt,26,27,0,
,2021-06-18 12:00:00,966,439,527,Leicht bewölkt,27,28,0,
,2021-06-18 13:00:00,1176,521,655,Leicht bewölkt,27,28,0,
,2021-06-18 14:00:00,860,372,488,Leicht bewölkt,27,29,0,
,2021-06-18 15:00:00,921,426,495,Leicht bewölkt,28,29,0,
,2021-06-18 16:00:00,930,426,504,Leicht bewölkt,27,28,0,
,2021-06-18 17:00:00,976,505,471,Stellenweiser Regenfall,26,27,0.3,
,2021-06-18 18:00:00,909,460,449,Stellenweiser Regenfall,25,26,0.4,
,2021-06-18 19:00:00,856,410,446,Stellenweiser Regenfall,23,25,0.2,
,2021-06-18 20:00:00,637,306,331,Nieselregen mit Gewitter,22,22,1.9,
,2021-06-18 21:00:00,477,216,261,Nieselregen mit Gewitter,20,20,2.6,
,2021-06-18 22:00:00,341,99,242,Nieselregen mit Gewitter,20,20,1.3,
,2021-06-18 23:00:00,304,138,166,Teilweise starker Regenfall,19,19,3.7,
,2021-06-19 00:00:00,202,77,125,Teilweise starker Regenfall,18,18,7.4,
,2021-06-19 01:00:00,150,51,99,Teilweise starker Regenfall,17,17,3.7,
,2021-06-19 02:00:00,75,23,52,Teilweise starker Regenfall,17,17,1.2,
,2021-06-19 03:00:00,34,10,24,Teilweise starker Regenfall,16,16,1.6,
,2021-06-19 04:00:00,36,6,30,Teilweise starker Regenfall,16,16,0.8,
,2021-06-19 05:00:00,58,21,37,Leicht bewölkt,17,17,0,
,2021-06-19 06:00:00,72,37,35,Leicht bewölkt,18,18,0,
,2021-06-19 07:00:00,139,68,71,Leicht bewölkt,20,20,0,
,2021-06-19 08:00:00,325,180,145,Leicht bewölkt,22,22,0,
,2021-06-19 09:00:00,617,332,285,Leicht bewölkt,24,24,0,
,2021-06-19 10:00:00,737,388,349,Leicht bewölkt,25,26,0,
,2021-06-19 11:00:00,806,474,332,Leicht bewölkt,26,27,0,
,2021-06-19 12:00:00,758,366,392,Leicht bewölkt,27,28,0,
,2021-06-19 13:00:00,746,368,378,Leicht bewölkt,27,28,0,
,2021-06-19 14:00:00,737,390,347,Leicht bewölkt,28,29,0,
,2021-06-19 15:00:00,710,338,372,Leicht bewölkt,28,29,0,
,2021-06-19 16:00:00,771,361,410,Leicht bewölkt,27,29,0,
,2021-06-19 17:00:00,1051,507,544,Leicht bewölkt,26,28,0,
,2021-06-19 18:00:00,583,247,336,Leicht bewölkt,26,27,0,
,2021-06-19 19:00:00,375,190,185,Leicht bewölkt,24,26,0,
,2021-06-19 20:00:00,566,285,281,Leicht bewölkt,23,24,0,
,2021-06-19 21:00:00,471,237,234,Leicht bewölkt,21,21,0,
,2021-06-19 22:00:00,334,153,181,Leicht bewölkt,20,20,0,
,2021-06-19 23:00:00,374,171,203,Stellenweiser Regenfall,20,20,0,
,2021-06-20 00:00:00,279,101,178,Stellenweiser Regenfall,19,19,0,
,2021-06-20 01:00:00,161,60,101,Stellenweiser Regenfall,18,18,0,
,2021-06-20 02:00:00,114,35,79,Leicht bewölkt,18,18,0,
,2021-06-20 03:00:00,78,16,62,Leicht bewölkt,17,17,0,
,2021-06-20 04:00:00,20,2,18,Leicht bewölkt,18,18,0,
,2021-06-20 05:00:00,32,11,21,Leicht bewölkt,19,19,0,
,2021-06-20 06:00:00,30,17,13,Leicht bewölkt,20,20,0,
,2021-06-20 07:00:00,47,23,24,Leicht bewölkt,22,22,0,
,2021-06-20 08:00:00,121,65,56,Leicht bewölkt,23,24,0,
,2021-06-20 09:00:00,273,145,128,Leicht bewölkt,24,26,0,
,2021-06-20 10:00:00,373,197,176,Leicht bewölkt,25,26,0,
,2021-06-20 11:00:00,409,219,190,Leicht bewölkt,26,27,0,
,2021-06-20 12:00:00,461,214,247,Leicht bewölkt,27,28,0,
,2021-06-20 13:00:00,482,236,246,Leicht bewölkt,26,27,0,
,2021-06-20 14:00:00,539,287,252,Leicht bewölkt,25,27,0.5,
,2021-06-20 15:00:00,537,262,275,Leicht bewölkt,25,26,0.7,
,2021-06-20 16:00:00,591,319,272,Leicht bewölkt,23,25,0.3,
,2021-06-20 17:00:00,746,344,402,Leichter Regenschauer,22,22,0.3,
,2021-06-20 18:00:00,379,179,200,Leichter Regenschauer,20,20,0.4,
,2021-06-20 19:00:00,168,80,88,Leichter Regenschauer,19,19,0.2,
,2021-06-20 20:00:00,225,100,125,Leichter Regenschauer,19,19,0.2,
,2021-06-20 21:00:00,137,61,76,Leichter Regenschauer,18,18,0.2,
,2021-06-20 22:00:00,96,46,50,Leichter Regenschauer,16,16,0.1,
,2021-06-20 23:00:00,47,27,20,Stellenweiser Regenfall,15,15,0,
,2021-06-21 00:00:00,35,14,21,Stellenweiser Regenfall,13,13,0.1,
,2021-06-21 01:00:00,18,11,7,Stellenweiser Regenfall,13,13,0,
,2021-06-21 02:00:00,6,2,4,Stellenweiser Regenfall,13,13,0,
,2021-06-21 03:00:00,3,2,1,Stellenweiser Regenfall,13,13,0,
,2021-06-21 04:00:00,10,5,5,Stellenweiser Regenfall,14,14,0,
,2021-06-21 05:00:00,39,20,19,Bewölkt,15,15,0,
,2021-06-21 06:00:00,194,109,85,Bewölkt,16,16,0,
,2021-06-21 07:00:00,1058,661,397,Bewölkt,18,18,0,
,2021-06-21 08:00:00,798,435,363,Stellenweiser Regenfall,19,19,0,
,2021-06-21 09:00:00,701,408,293,Stellenweiser Regenfall,21,21,0,
,2021-06-21 10:00:00,497,261,236,Stellenweiser Regenfall,22,24,0,
,2021-06-21 11:00:00,688,319,369,Stellenweiser Regenfall,23,25,0.1,
,2021-06-21 12:00:00,786,363,423,Stellenweiser Regenfall,24,26,0.1,
,2021-06-21 13:00:00,1098,510,588,Stellenweiser Regenfall,24,26,0.1,
,2021-06-21 14:00:00,858,427,431,Nieselregen mit Gewitter,24,25,0.5,
,2021-06-21 15:00:00,1043,501,542,Nieselregen mit Gewitter,24,25,0.7,
,2021-06-21 16:00:00,1066,519,547,Nieselregen mit Gewitter,23,24,0.4,
,2021-06-21 17:00:00,1080,539,541,Leichter Regenschauer,22,22,1.4,
,2021-06-21 18:00:00,886,386,500,Leichter Regenschauer,21,21,1.9,
,2021-06-21 19:00:00,666,287,379,Leichter Regenschauer,20,20,0.9,
,2021-06-21 20:00:00,263,122,141,Mäßiger bis starker Regenschauer,18,18,0.9,
,2021-06-21 21:00:00,206,89,117,Mäßiger bis starker Regenschauer,17,17,1.2,
,2021-06-21 22:00:00,143,68,75,Mäßiger bis starker Regenschauer,17,17,0.6,
,2021-06-21 23:00:00,74,39,35,Stellenweiser Regenfall,17,17,0.1,
,2021-06-22 00:00:00,38,20,18,Stellenweiser Regenfall,17,18,0.1,
,2021-06-22 01:00:00,15,9,6,Stellenweiser Regenfall,16,17,0.1,
,2021-06-22 02:00:00,11,4,7,Stellenweiser Regenfall,15,16,0.8,
,2021-06-22 03:00:00,4,2,2,Stellenweiser Regenfall,14,15,1,
,2021-06-22 04:00:00,9,4,5,Stellenweiser Regenfall,15,15,0.5,
,2021-06-22 05:00:00,56,34,22,Mäßiger bis starker Regenschauer,15,15,1.3,
,2021-06-22 06:00:00,223,126,97,Mäßiger bis starker Regenschauer,16,16,1.7,
,2021-06-22 07:00:00,1115,714,401,Mäßiger bis starker Regenschauer,17,17,0.8,
,2021-06-22 08:00:00,850,464,386,Mäßiger bis starker Regenschauer,18,18,0.5,
,2021-06-22 09:00:00,691,363,328,Mäßiger bis starker Regenschauer,19,19,0.6,
,2021-06-22 10:00:00,520,298,222,Mäßiger bis starker Regenschauer,20,20,0.3,
,2021-06-22 11:00:00,619,294,325,Stellenweiser Regenfall,21,21,0,
,2021-06-22 12:00:00,715,300,415,Stellenweiser Regenfall,22,22,0,
,2021-06-22 13:00:00,869,344,525,Stellenweiser Regenfall,22,22,0,
,2021-06-22 14:00:00,719,337,382,Stellenweise Gewitter und Niederschläge,22,22,1,
,2021-06-22 15:00:00,903,453,450,Stellenweise Gewitter und Niederschläge,22,22,1.3,
,2021-06-22 16:00:00,934,467,467,Stellenweise Gewitter und Niederschläge,21,21,0.6,
,2021-06-22 17:00:00,1059,480,579,Mäßiger bis starker Regenschauer,20,20,0.5,
,2021-06-22 18:00:00,890,384,506,Mäßiger bis starker Regenschauer,20,20,0.6,
,2021-06-22 19:00:00,700,329,371,Mäßiger bis starker Regenschauer,19,19,0.3,
,2021-06-22 20:00:00,462,210,252,Leicht bewölkt,18,18,0.1,
,2021-06-22 21:00:00,318,122,196,Leicht bewölkt,17,17,0.2,
,2021-06-22 22:00:00,194,78,116,Leicht bewölkt,16,16,0.1,
,2021-06-22 23:00:00,111,44,67,Starker Regenfall,16,16,3.4,
,2021-06-23 00:00:00,55,29,26,Starker Regenfall,16,16,6.9,
,2021-06-23 01:00:00,22,13,9,Starker Regenfall,15,15,3.4,
,2021-06-23 02:00:00,11,5,6,Teilweise starker Regenfall,15,15,1.1,
,2021-06-23 03:00:00,2,1,1,Teilweise starker Regenfall,15,15,1.5,
,2021-06-23 04:00:00,14,10,4,Teilweise starker Regenfall,16,16,0.7,
,2021-06-23 05:00:00,65,41,24,Leichter Nebel,16,16,0,
,2021-06-23 06:00:00,204,121,83,Leichter Nebel,16,16,0,
,2021-06-23 07:00:00,1032,638,394,Leichter Nebel,18,18,0,
,2021-06-23 08:00:00,824,422,402,Leicht bewölkt,19,19,0,
,2021-06-23 09:00:00,677,409,268,Leicht bewölkt,20,20,0,
,2021-06-23 10:00:00,539,293,246,Leicht bewölkt,21,21,0,
,2021-06-23 11:00:00,686,327,359,Leicht bewölkt,22,24,0,
,2021-06-23 12:00:00,813,405,408,Leicht bewölkt,23,25,0,
,2021-06-23 13:00:00,1123,546,577,Leicht bewölkt,24,25,0,
,2021-06-23 14:00:00,899,448,451,Leicht bewölkt,24,25,0,
,2021-06-23 15:00:00,1091,514,577,Leicht bewölkt,24,25,0,
,2021-06-23 16:00:00,1038,520,518,Leicht bewölkt,23,24,0,
,2021-06-23 17:00:00,1163,551,612,Leicht bewölkt,22,23,0.1,
,2021-06-23 18:00:00,1093,507,586,Leicht bewölkt,21,21,0.1,
,2021-06-23 19:00:00,773,382,391,Leicht bewölkt,20,20,0.1,
,2021-06-23 20:00:00,523,233,290,Nieselregen mit Gewitter,19,19,0.1,
,2021-06-23 21:00:00,223,100,123,Nieselregen mit Gewitter,18,18,0.2,
,2021-06-23 22:00:00,82,22,60,Nieselregen mit Gewitter,17,17,0.1,
,2021-06-23 23:00:00,396,140,256,Mäßiger bis starker Regenschauer,16,16,3.3,
,2021-06-24 00:00:00,125,47,78,Mäßiger bis starker Regenschauer,14,15,6.6,
,2021-06-24 01:00:00,67,25,42,Mäßiger bis starker Regenschauer,14,14,3.3,
,2021-06-24 02:00:00,17,7,10,Sintflutartiger Regenfall,13,14,1.3,
,2021-06-24 03:00:00,21,5,16,Sintflutartiger Regenfall,13,13,1.7,
,2021-06-24 04:00:00,20,10,10,Sintflutartiger Regenfall,13,14,0.8,
,2021-06-24 05:00:00,67,37,30,Leichter Nebel,14,14,0,
,2021-06-24 06:00:00,177,98,79,Leichter Nebel,14,14,0,
,2021-06-24 07:00:00,1084,699,385,Leichter Nebel,16,16,0,
,2021-06-24 08:00:00,757,400,357,Bewölkt,17,17,0.1,
,2021-06-24 09:00:00,737,402,335,Bewölkt,18,18,0.1,
,2021-06-24 10:00:00,480,255,225,Bewölkt,19,19,0,
,2021-06-24 11:00:00,520,262,258,Stellenweiser Regenfall,20,20,0.1,
,2021-06-24 12:00:00,710,331,379,Stellenweiser Regenfall,21,21,0.1,
,2021-06-24 13:00:00,945,416,529,Stellenweiser Regenfall,21,21,0.1,
,2021-06-24 14:00:00,860,387,473,Leichter Regenschauer,21,21,0.6,
,2021-06-24 15:00:00,990,476,514,Leichter Regenschauer,21,21,0.8,
,2021-06-24 16:00:00,969,481,488,Leichter Regenschauer,19,19,0.4,
,2021-06-24 17:00:00,912,417,495,Leichter Regenschauer,18,18,2.9,
,2021-06-24 18:00:00,667,297,370,Leichter Regenschauer,17,17,3.9,
,2021-06-24 19:00:00,459,186,273,Leichter Regenschauer,17,17,1.9,
,2021-06-24 20:00:00,369,158,211,Sintflutartiger Regenfall,16,16,1.5,
,2021-06-24 21:00:00,258,122,136,Sintflutartiger Regenfall,15,15,2,
,2021-06-24 22:00:00,184,87,97,Sintflutartiger Regenfall,14,14,1,
,2021-06-24 23:00:00,116,47,69,Teilweise mäßiger Regenfall,13,13,1.4,
,2021-06-25 00:00:00,56,30,26,Teilweise mäßiger Regenfall,12,12,2.9,
,2021-06-25 01:00:00,21,11,10,Teilweise mäßiger Regenfall,12,12,1.4,
,2021-06-25 02:00:00,22,5,17,Teilweise mäßiger Regenfall,12,12,0.4,
,2021-06-25 03:00:00,5,0,5,Teilweise mäßiger Regenfall,12,12,0.5,
,2021-06-25 04:00:00,15,6,9,Teilweise mäßiger Regenfall,13,13,0.3,
,2021-06-25 05:00:00,59,36,23,Leicht bewölkt,13,13,0,
,2021-06-25 06:00:00,193,106,87,Leicht bewölkt,13,14,0,
,2021-06-25 07:00:00,988,659,329,Leicht bewölkt,14,15,0,
,2021-06-25 08:00:00,765,418,347,Leicht bewölkt,15,16,0,
,2021-06-25 09:00:00,671,377,294,Leicht bewölkt,16,17,0,
,2021-06-25 10:00:00,598,339,259,Leicht bewölkt,17,17,0,
,2021-06-25 11:00:00,666,319,347,Stellenweiser Regenfall,18,18,0.2,
,2021-06-25 12:00:00,845,411,434,Stellenweiser Regenfall,19,19,0.3,
,2021-06-25 13:00:00,1066,422,644,Stellenweiser Regenfall,19,19,0.1,
,2021-06-25 14:00:00,949,458,491,Nieselregen mit Gewitter,19,19,0.7,
,2021-06-25 15:00:00,955,461,494,Nieselregen mit Gewitter,19,19,0.9,
,2021-06-25 16:00:00,927,484,443,Nieselregen mit Gewitter,19,19,0.4,
,2021-06-25 17:00:00,945,441,504,Mäßiger bis starker Regenschauer,19,19,1,
,2021-06-25 18:00:00,951,463,488,Mäßiger bis starker Regenschauer,18,18,1.3,
,2021-06-25 19:00:00,769,385,384,Mäßiger bis starker Regenschauer,17,17,0.7,
,2021-06-25 20:00:00,542,290,252,Mäßiger bis starker Regenschauer,16,16,0.4,
,2021-06-25 21:00:00,419,192,227,Mäßiger bis starker Regenschauer,16,16,0.5,
,2021-06-25 22:00:00,325,143,182,Mäßiger bis starker Regenschauer,15,15,0.3,
,2021-06-25 23:00:00,256,68,188,Stellenweiser Regenfall,14,14,0.1,
,2021-06-26 00:00:00,253,82,171,Stellenweiser Regenfall,13,13,0.2,
,2021-06-26 01:00:00,156,55,101,Stellenweiser Regenfall,12,12,0.1,
,2021-06-26 02:00:00,100,35,65,Stellenweiser Regenfall,11,12,0,
,2021-06-26 03:00:00,47,17,30,Stellenweiser Regenfall,11,11,0,
,2021-06-26 04:00:00,28,4,24,Stellenweiser Regenfall,12,12,0,
,2021-06-26 05:00:00,40,26,14,Leicht bewölkt,13,13,0,
,2021-06-26 06:00:00,70,37,33,Leicht bewölkt,14,14,0,
,2021-06-26 07:00:00,117,61,56,Leicht bewölkt,15,16,0,
,2021-06-26 08:00:00,307,156,151,Leicht bewölkt,17,17,0,
,2021-06-26 09:00:00,479,285,194,Leicht bewölkt,19,19,0,
,2021-06-26 10:00:00,683,361,322,Leicht bewölkt,20,20,0,
,2021-06-26 11:00:00,761,403,358,Leicht bewölkt,21,21,0,
,2021-06-26 12:00:00,792,411,381,Leicht bewölkt,22,24,0,
,2021-06-26 13:00:00,814,402,412,Leicht bewölkt,23,24,0,
,2021-06-26 14:00:00,793,403,390,Leicht bewölkt,23,25,0,
,2021-06-26 15:00:00,765,377,388,Leicht bewölkt,24,25,0,
,2021-06-26 16:00:00,865,444,421,Leicht bewölkt,23,24,0,
,2021-06-26 17:00:00,868,464,404,Leicht bewölkt,22,23,0,
,2021-06-26 18:00:00,833,427,406,Leicht bewölkt,21,21,0,
,2021-06-26 19:00:00,689,337,352,Leicht bewölkt,20,20,0,
,2021-06-26 20:00:00,685,372,313,Leicht bewölkt,19,19,0,
,2021-06-26 21:00:00,462,202,260,Leicht bewölkt,17,17,0,
,2021-06-26 22:00:00,383,217,166,Leicht bewölkt,16,16,0,
,2021-06-26 23:00:00,358,140,218,Leicht bewölkt,15,15,0,
,2021-06-27 00:00:00,351,83,268,Leicht bewölkt,15,15,0,
,2021-06-27 01:00:00,224,65,159,Leicht bewölkt,14,14,0,
,2021-06-27 02:00:00,156,25,131,Leicht bewölkt,14,14,0,
,2021-06-27 03:00:00,90,16,74,Leicht bewölkt,13,14,0,
,2021-06-27 04:00:00,68,23,45,Leicht bewölkt,14,15,0,
,2021-06-27 05:00:00,44,17,27,Leicht bewölkt,15,16,0,
,2021-06-27 06:00:00,54,29,25,Leicht bewölkt,16,17,0,
,2021-06-27 07:00:00,97,55,42,Leicht bewölkt,18,18,0,
,2021-06-27 08:00:00,137,65,72,Leicht bewölkt,20,20,0,
,2021-06-27 09:00:00,375,205,170,Leicht bewölkt,22,22,0,
,2021-06-27 10:00:00,489,257,232,Leicht bewölkt,23,24,0,
,2021-06-27 11:00:00,589,278,311,Leicht bewölkt,24,25,0,
,2021-06-27 12:00:00,526,217,309,Leicht bewölkt,25,27,0,
,2021-06-27 13:00:00,617,279,338,Leicht bewölkt,26,27,0,
,2021-06-27 14:00:00,630,341,289,Leicht bewölkt,26,27,0,
,2021-06-27 15:00:00,610,314,296,Leicht bewölkt,27,28,0,
,2021-06-27 16:00:00,634,327,307,Leicht bewölkt,26,27,0,
,2021-06-27 17:00:00,639,353,286,Leicht bewölkt,25,27,0,
,2021-06-27 18:00:00,593,301,292,Leicht bewölkt,24,26,0,
,2021-06-27 19:00:00,549,300,249,Leicht bewölkt,23,24,0,
,2021-06-27 20:00:00,467,222,245,Leicht bewölkt,21,21,0,
,2021-06-27 21:00:00,376,140,236,Leicht bewölkt,20,20,0,
,2021-06-27 22:00:00,132,39,93,Leicht bewölkt,19,19,0,
,2021-06-27 23:00:00,124,42,82,Leicht bewölkt,18,18,0,
,2021-06-28 00:00:00,31,7,24,Leicht bewölkt,17,17,0,
,2021-06-28 01:00:00,22,10,12,Leicht bewölkt,16,16,0,
,2021-06-28 02:00:00,8,4,4,Leicht bewölkt,16,16,0,
,2021-06-28 03:00:00,7,2,5,Leicht bewölkt,15,15,0,
,2021-06-28 04:00:00,11,5,6,Leicht bewölkt,16,16,0,
,2021-06-28 05:00:00,58,31,27,Leicht bewölkt,17,17,0,
,2021-06-28 06:00:00,217,130,87,Leicht bewölkt,18,18,0,
,2021-06-28 07:00:00,1109,726,383,Leicht bewölkt,20,20,0,
,2021-06-28 08:00:00,776,428,348,Leicht bewölkt,22,22,0,
,2021-06-28 09:00:00,700,390,310,Leicht bewölkt,24,24,0,
,2021-06-28 10:00:00,584,297,287,Leicht bewölkt,25,26,0,
,2021-06-28 11:00:00,678,328,350,Leicht bewölkt,26,27,0,
,2021-06-28 12:00:00,790,357,433,Leicht bewölkt,27,28,0,
,2021-06-28 13:00:00,1068,507,561,Leicht bewölkt,27,28,0,
,2021-06-28 14:00:00,876,398,478,Leicht bewölkt,28,29,0,
,2021-06-28 15:00:00,1023,502,521,Leicht bewölkt,28,29,0,
,2021-06-28 16:00:00,1002,493,509,Leicht bewölkt,27,29,0,
,2021-06-28 17:00:00,1107,524,583,Leicht bewölkt,27,29,0,
,2021-06-28 18:00:00,975,450,525,Leicht bewölkt,26,29,0,
,2021-06-28 19:00:00,696,317,379,Leicht bewölkt,25,28,0,
,2021-06-28 20:00:00,262,101,161,Stellenweiser Regenfall,24,27,0.4,
,2021-06-28 21:00:00,209,85,124,Stellenweiser Regenfall,23,26,0.6,
,2021-06-28 22:00:00,112,30,82,Stellenweiser Regenfall,22,22,0.3,
,2021-06-28 23:00:00,54,21,33,Leichter Regenschauer,20,20,0.2,
,2021-06-29 00:00:00,65,30,35,Leichter Regenschauer,18,18,0.4,
,2021-06-29 01:00:00,21,15,6,Leichter Regenschauer,18,18,0.2,
,2021-06-29 02:00:00,4,2,2,Leichter Nebel,17,17,0.1,
,2021-06-29 03:00:00,2,1,1,Leichter Nebel,17,17,0.1,
,2021-06-29 04:00:00,9,5,4,Leichter Nebel,16,16,0.1,
,2021-06-29 05:00:00,26,17,9,Leichter Regenschauer,16,16,0,
,2021-06-29 06:00:00,108,58,50,Leichter Regenschauer,16,16,0,
,2021-06-29 07:00:00,807,491,316,Leichter Regenschauer,17,17,0,
,2021-06-29 08:00:00,721,384,337,Leichter Nebel,18,18,0.2,
,2021-06-29 09:00:00,680,397,283,Leichter Nebel,18,18,0.3,
,2021-06-29 10:00:00,523,286,237,Leichter Nebel,19,19,0.2,
,2021-06-29 11:00:00,669,345,324,Leichter Regenschauer,21,21,0.3,
,2021-06-29 12:00:00,707,323,384,Leichter Regenschauer,22,22,0.4,
,2021-06-29 13:00:00,1042,462,580,Leichter Regenschauer,21,21,0.2,
,2021-06-29 14:00:00,354,139,215,Leichter Regenschauer,20,20,2.8,
,2021-06-29 15:00:00,684,324,360,Leichter Regenschauer,19,19,3.7,
,2021-06-29 16:00:00,764,382,382,Leichter Regenschauer,18,18,1.9,
,2021-06-29 17:00:00,1168,579,589,Starker Regenfall,16,16,5.8,
,2021-06-29 18:00:00,493,207,286,Starker Regenfall,15,15,7.8,
,2021-06-29 19:00:00,301,150,151,Starker Regenfall,14,14,3.9,
,2021-06-29 20:00:00,498,190,308,Teilweise starker Regenfall,13,13,2.2,
,2021-06-29 21:00:00,323,135,188,Teilweise starker Regenfall,12,12,3,
,2021-06-29 22:00:00,256,102,154,Teilweise starker Regenfall,13,13,1.5,
,2021-06-29 23:00:00,125,49,76,Leicht bewölkt,14,14,0,
,2021-06-30 00:00:00,81,30,51,Leicht bewölkt,15,15,0,
,2021-06-30 01:00:00,39,13,26,Leicht bewölkt,14,14,0,
,2021-06-30 02:00:00,8,3,5,Leichter Nebel,14,14,0.1,
,2021-06-30 03:00:00,5,4,1,Leichter Nebel,13,13,0.1,
,2021-06-30 04:00:00,12,6,6,Leichter Nebel,14,14,0.1,
,2021-06-30 05:00:00,44,31,13,Stellenweiser Nieselregen,14,14,0.3,
,2021-06-30 06:00:00,193,108,85,Stellenweiser Nieselregen,14,14,0.4,
,2021-06-30 07:00:00,970,587,383,Stellenweiser Nieselregen,14,14,0.2,
,2021-06-30 08:00:00,744,417,327,Stellenweiser leichter Regenfall,14,14,1.1,
,2021-06-30 09:00:00,661,403,258,Stellenweiser leichter Regenfall,14,14,1.4,
,2021-06-30 10:00:00,484,256,228,Stellenweiser leichter Regenfall,14,14,0.7,
,2021-06-30 11:00:00,581,281,300,Mäßiger Regenfall,14,14,1.5,
,2021-06-30 12:00:00,754,382,372,Mäßiger Regenfall,14,14,2,
,2021-06-30 13:00:00,987,440,547,Mäßiger Regenfall,14,14,1,
,2021-06-30 14:00:00,711,341,370,Mäßiger Regenfall,14,14,1.5,
,2021-06-30 15:00:00,865,374,491,Mäßiger Regenfall,14,14,2,
,2021-06-30 16:00:00,912,450,462,Mäßiger Regenfall,13,13,1,
,2021-06-30 17:00:00,1027,470,557,Mäßiger Regenfall,13,13,1.2,
,2021-06-30 18:00:00,748,274,474,Mäßiger Regenfall,13,13,1.6,
,2021-06-30 19:00:00,442,173,269,Mäßiger Regenfall,12,12,0.8,
,2021-06-30 20:00:00,355,174,181,Teilweise mäßiger Regenfall,12,12,0.3,
,2021-06-30 21:00:00,204,77,127,Teilweise mäßiger Regenfall,12,12,0.4,
,2021-06-30 22:00:00,147,72,75,Teilweise mäßiger Regenfall,12,12,0.2,
,2021-06-30 23:00:00,88,33,55,Leichter Regenschauer,12,12,0.7,
,2021-07-01 00:00:00,29,13,16,Leichter Regenschauer,13,12,1.3,
,2021-07-01 01:00:00,41,14,27,Leichter Regenschauer,12,12,0.7,
,2021-07-01 02:00:00,7,3,4,Leichter Regenschauer,12,11,1.3,
,2021-07-01 03:00:00,7,2,5,Leichter Regenschauer,12,11,1.7,
,2021-07-01 04:00:00,6,2,4,Leichter Regenschauer,12,11,0.8,
,2021-07-01 05:00:00,32,18,14,Mäßiger Regenfall,12,11,1.3,
,2021-07-01 06:00:00,149,99,50,Mäßiger Regenfall,12,11,1.7,
,2021-07-01 07:00:00,821,520,301,Mäßiger Regenfall,13,12,0.8,
,2021-07-01 08:00:00,746,408,338,Mäßiger Regenfall,14,14,0.4,
,2021-07-01 09:00:00,646,389,257,Mäßiger Regenfall,16,15,0.5,
,2021-07-01 10:00:00,416,244,172,Mäßiger Regenfall,17,16,0.3,
,2021-07-01 11:00:00,520,269,251,Bewölkt,18,18,0,
,2021-07-01 12:00:00,691,324,367,Bewölkt,19,19,0,
,2021-07-01 13:00:00,860,400,460,Bewölkt,19,19,0,
,2021-07-01 14:00:00,701,322,379,Leicht bewölkt,19,19,0.1,
,2021-07-01 15:00:00,936,442,494,Leicht bewölkt,19,19,0.2,
,2021-07-01 16:00:00,931,456,475,Leicht bewölkt,19,19,0.1,
,2021-07-01 17:00:00,974,436,538,Stellenweiser Regenfall,18,18,0.3,
,2021-07-01 18:00:00,924,412,512,Stellenweiser Regenfall,18,18,0.4,
,2021-07-01 19:00:00,640,299,341,Stellenweiser Regenfall,17,17,0.2,
,2021-07-01 20:00:00,472,187,285,Stellenweiser Regenfall,15,15,0.1,
,2021-07-01 21:00:00,354,159,195,Stellenweiser Regenfall,14,14,0.2,
,2021-07-01 22:00:00,270,94,176,Stellenweiser Regenfall,14,14,0.1,
,2021-07-01 23:00:00,149,46,103,Stellenweiser Regenfall,14,14,0,
,2021-07-02 00:00:00,79,39,40,Stellenweiser Regenfall,14,14,0,
,2021-07-02 01:00:00,54,21,33,Stellenweiser Regenfall,13,14,0,
,2021-07-02 02:00:00,14,6,8,Leicht bewölkt,13,13,0,
,2021-07-02 03:00:00,9,1,8,Leicht bewölkt,12,13,0,
,2021-07-02 04:00:00,14,10,4,Leicht bewölkt,13,13,0,
,2021-07-02 05:00:00,63,39,24,Leicht bewölkt,13,14,0,
,2021-07-02 06:00:00,184,123,61,Leicht bewölkt,14,14,0,
,2021-07-02 07:00:00,952,632,320,Leicht bewölkt,15,15,0,
,2021-07-02 08:00:00,902,520,382,Leicht bewölkt,16,16,0,
,2021-07-02 09:00:00,806,477,329,Leicht bewölkt,17,18,0,
,2021-07-02 10:00:00,657,341,316,Leicht bewölkt,19,19,0,
,2021-07-02 11:00:00,773,391,382,Leicht bewölkt,20,20,0,
,2021-07-02 12:00:00,965,476,489,Leicht bewölkt,21,21,0,
,2021-07-02 13:00:00,1233,467,766,Leicht bewölkt,21,21,0,
,2021-07-02 14:00:00,961,465,496,Leicht bewölkt,21,21,0,
,2021-07-02 15:00:00,978,466,512,Leicht bewölkt,21,21,0,
,2021-07-02 16:00:00,1033,550,483,Leicht bewölkt,21,21,0,
,2021-07-02 17:00:00,1034,496,538,Stellenweiser Regenfall,21,21,0.1,
,2021-07-02 18:00:00,958,464,494,Stellenweiser Regenfall,20,20,0.1,
,2021-07-02 19:00:00,760,388,372,Stellenweiser Regenfall,19,19,0.1,
,2021-07-02 20:00:00,572,291,281,Stellenweiser Regenfall,18,18,0,
,2021-07-02 21:00:00,531,256,275,Stellenweiser Regenfall,17,17,0,
,2021-07-02 22:00:00,411,174,237,Stellenweiser Regenfall,16,16,0,
,2021-07-02 23:00:00,311,96,215,Leicht bewölkt,15,15,0,
,2021-07-03 00:00:00,210,57,153,Leicht bewölkt,14,14,0,
,2021-07-03 01:00:00,186,40,146,Leicht bewölkt,13,13,0,
,2021-07-03 02:00:00,124,31,93,Leicht bewölkt,13,13,0,
,2021-07-03 03:00:00,51,10,41,Leicht bewölkt,12,12,0,
,2021-07-03 04:00:00,29,6,23,Leicht bewölkt,13,13,0,
,2021-07-03 05:00:00,48,22,26,Leicht bewölkt,14,14,0,
,2021-07-03 06:00:00,75,39,36,Leicht bewölkt,15,15,0,
,2021-07-03 07:00:00,124,74,50,Leicht bewölkt,17,17,0,
,2021-07-03 08:00:00,336,179,157,Leicht bewölkt,19,19,0,
,2021-07-03 09:00:00,651,413,238,Leicht bewölkt,20,20,0,
,2021-07-03 10:00:00,716,368,348,Leicht bewölkt,22,22,0,
,2021-07-03 11:00:00,844,470,374,Leicht bewölkt,23,24,0,
,2021-07-03 12:00:00,770,400,370,Leicht bewölkt,24,26,0,
,2021-07-03 13:00:00,779,355,424,Leicht bewölkt,23,24,0,
,2021-07-03 14:00:00,879,417,462,Leicht bewölkt,23,23,0,
,2021-07-03 15:00:00,730,363,367,Leicht bewölkt,22,22,0,
,2021-07-03 16:00:00,827,394,433,Leicht bewölkt,20,20,0,
,2021-07-03 17:00:00,882,415,467,Stellenweiser Nieselregen,19,19,0.2,
,2021-07-03 18:00:00,609,282,327,Stellenweiser Nieselregen,17,17,0.2,
,2021-07-03 19:00:00,425,195,230,Stellenweiser Nieselregen,16,16,0.1,
,2021-07-03 20:00:00,290,130,160,Nieselregen,15,15,0.2,
,2021-07-03 21:00:00,234,118,116,Nieselregen,15,15,0.3,
,2021-07-03 22:00:00,217,96,121,Nieselregen,15,15,0.1,
,2021-07-03 23:00:00,163,63,100,Leichter Regenfall,16,16,0.8,
,2021-07-04 00:00:00,195,79,116,Leichter Regenfall,16,17,1.6,
,2021-07-04 01:00:00,113,34,79,Leichter Regenfall,16,16,0.8,
,2021-07-04 02:00:00,84,20,64,Mäßiger Regenfall,15,15,0.4,
,2021-07-04 03:00:00,51,9,42,Mäßiger Regenfall,15,15,0.5,
,2021-07-04 04:00:00,37,11,26,Mäßiger Regenfall,15,15,0.2,
,2021-07-04 05:00:00,33,15,18,Nieselregen,15,16,0,
,2021-07-04 06:00:00,36,25,11,Nieselregen,16,16,0,
,2021-07-04 07:00:00,51,24,27,Nieselregen,17,17,0,
,2021-07-04 08:00:00,117,54,63,Bewölkt,18,18,0,
,2021-07-04 09:00:00,314,199,115,Bewölkt,20,20,0,
,2021-07-04 10:00:00,341,191,150,Bewölkt,21,21,0,
,2021-07-04 11:00:00,403,213,190,Leicht bewölkt,22,22,0,
,2021-07-04 12:00:00,467,227,240,Leicht bewölkt,23,24,0,
,2021-07-04 13:00:00,488,228,260,Leicht bewölkt,22,24,0,
,2021-07-04 14:00:00,495,227,268,Leicht bewölkt,22,24,0.4,
,2021-07-04 15:00:00,519,252,267,Leicht bewölkt,22,25,0.5,
,2021-07-04 16:00:00,294,147,147,Leicht bewölkt,21,21,0.2,
,2021-07-04 17:00:00,252,119,133,Leichter Regenschauer,20,20,0.6,
,2021-07-04 18:00:00,181,75,106,Leichter Regenschauer,20,20,0.8,
,2021-07-04 19:00:00,171,81,90,Leichter Regenschauer,18,18,0.4,
,2021-07-04 20:00:00,138,68,70,Leichter Regenfall,17,17,1.4,
,2021-07-04 21:00:00,111,45,66,Leichter Regenfall,16,16,1.8,
,2021-07-04 22:00:00,88,37,51,Leichter Regenfall,15,15,0.9,
,2021-07-04 23:00:00,50,21,29,Leichter Regenschauer,14,14,0,
,2021-07-05 00:00:00,41,18,23,Leichter Regenschauer,13,13,0.1,
,2021-07-05 01:00:00,15,8,7,Leichter Regenschauer,13,13,0,
,2021-07-05 02:00:00,6,0,6,Leicht bewölkt,12,12,0,
,2021-07-05 03:00:00,3,3,0,Leicht bewölkt,12,12,0,
,2021-07-05 04:00:00,17,13,4,Leicht bewölkt,12,13,0,
,2021-07-05 05:00:00,42,26,16,Leicht bewölkt,13,13,0,
,2021-07-05 06:00:00,215,129,86,Leicht bewölkt,14,14,0,
,2021-07-05 07:00:00,1025,674,351,Leicht bewölkt,15,15,0,
,2021-07-05 08:00:00,844,495,349,Leicht bewölkt,17,17,0,
,2021-07-05 09:00:00,636,347,289,Leicht bewölkt,18,18,0,
,2021-07-05 10:00:00,478,247,231,Leicht bewölkt,20,20,0,
,2021-07-05 11:00:00,577,258,319,Leicht bewölkt,21,21,0,
,2021-07-05 12:00:00,722,329,393,Leicht bewölkt,22,22,0,
,2021-07-05 13:00:00,932,411,521,Leicht bewölkt,22,24,0,
,2021-07-05 14:00:00,893,460,433,Leicht bewölkt,23,24,0,
,2021-07-05 15:00:00,962,468,494,Leicht bewölkt,24,25,0,
,2021-07-05 16:00:00,1020,441,579,Leicht bewölkt,23,25,0,
,2021-07-05 17:00:00,1103,546,557,Leicht bewölkt,23,25,0,
,2021-07-05 18:00:00,967,425,542,Leicht bewölkt,23,25,0,
,2021-07-05 19:00:00,739,337,402,Leicht bewölkt,22,24,0,
,2021-07-05 20:00:00,519,225,294,Leicht bewölkt,21,21,0,
,2021-07-05 21:00:00,393,160,233,Leicht bewölkt,21,21,0,
,2021-07-05 22:00:00,264,105,159,Leicht bewölkt,18,18,0,
,2021-07-05 23:00:00,125,51,74,Leicht bewölkt,16,16,0,
,2021-07-06 00:00:00,69,37,32,Leicht bewölkt,13,13,0,
,2021-07-06 01:00:00,23,9,14,Leicht bewölkt,13,13,0,
,2021-07-06 02:00:00,14,4,10,Leicht bewölkt,13,13,0,
,2021-07-06 03:00:00,5,2,3,Leicht bewölkt,13,13,0,
,2021-07-06 04:00:00,13,10,3,Leicht bewölkt,15,15,0,
,2021-07-06 05:00:00,61,39,22,Leicht bewölkt,16,16,0,
,2021-07-06 06:00:00,230,133,97,Leicht bewölkt,18,18,0,
,2021-07-06 07:00:00,994,651,343,Leicht bewölkt,20,20,0,
,2021-07-06 08:00:00,941,547,394,Sonnig,22,22,0,
,2021-07-06 09:00:00,796,449,347,Sonnig,24,25,0,
,2021-07-06 10:00:00,645,346,299,Sonnig,25,26,0,
,2021-07-06 11:00:00,791,404,387,Leicht bewölkt,27,27,0,
,2021-07-06 12:00:00,910,409,501,Leicht bewölkt,28,29,0,
,2021-07-06 13:00:00,1068,457,611,Leicht bewölkt,28,29,0,
,2021-07-06 14:00:00,850,394,456,Leicht bewölkt,29,29,0,
,2021-07-06 15:00:00,984,489,495,Leicht bewölkt,29,30,0,
,2021-07-06 16:00:00,824,366,458,Leicht bewölkt,28,30,0,
,2021-07-06 17:00:00,788,337,451,Leicht bewölkt,28,30,0.1,
,2021-07-06 18:00:00,784,371,413,Leicht bewölkt,27,30,0.2,
,2021-07-06 19:00:00,507,217,290,Leicht bewölkt,26,29,0.1,
,2021-07-06 20:00:00,351,157,194,Stellenweiser Regenfall,25,28,0.3,
,2021-07-06 21:00:00,187,77,110,Stellenweiser Regenfall,24,27,0.4,
,2021-07-06 22:00:00,152,52,100,Stellenweiser Regenfall,21,21,0.2,
,2021-07-06 23:00:00,146,62,84,Mäßiger bis starker Regenschauer,19,19,1.3,
,2021-07-07 00:00:00,98,39,59,Mäßiger bis starker Regenschauer,17,17,2.6,
,2021-07-07 01:00:00,27,10,17,Mäßiger bis starker Regenschauer,16,16,1.3,
,2021-07-07 02:00:00,4,3,1,Mäßiger bis starker Regenschauer,16,16,1,
,2021-07-07 03:00:00,6,4,2,Mäßiger bis starker Regenschauer,16,16,1.3,
,2021-07-07 04:00:00,11,7,4,Mäßiger bis starker Regenschauer,16,16,0.7,
,2021-07-07 05:00:00,40,24,16,Leichter Regenfall,16,16,0.3,
,2021-07-07 06:00:00,165,97,68,Leichter Regenfall,16,16,0.4,
,2021-07-07 07:00:00,731,456,275,Leichter Regenfall,16,16,0.2,
,2021-07-07 08:00:00,603,328,275,Nebel,16,16,0.1,
,2021-07-07 09:00:00,447,253,194,Nebel,16,16,0.2,
,2021-07-07 10:00:00,321,178,143,Nebel,17,17,0.1,
,2021-07-07 11:00:00,361,165,196,Nieselregen,17,17,0.1,
,2021-07-07 12:00:00,528,248,280,Nieselregen,18,18,0.1,
,2021-07-07 13:00:00,702,334,368,Nieselregen,18,18,0,
,2021-07-07 14:00:00,545,265,280,Bewölkt,18,18,0,
,2021-07-07 15:00:00,676,325,351,Bewölkt,19,19,0,
,2021-07-07 16:00:00,745,372,373,Bewölkt,18,18,0,
,2021-07-07 17:00:00,811,404,407,Stellenweiser Regenfall,17,17,0,
,2021-07-07 18:00:00,785,342,443,Stellenweiser Regenfall,16,16,0,
,2021-07-07 19:00:00,527,227,300,Stellenweiser Regenfall,15,15,0,
,2021-07-07 20:00:00,518,251,267,Stellenweiser Regenfall,13,13,0,
,2021-07-07 21:00:00,277,125,152,Stellenweiser Regenfall,12,12,0,
,2021-07-07 22:00:00,180,81,99,Stellenweiser Regenfall,12,12,0,
,2021-07-07 23:00:00,179,63,116,Leicht bewölkt,12,12,0.6,
,2021-07-08 00:00:00,107,31,76,Leicht bewölkt,12,12,1.1,
,2021-07-08 01:00:00,61,7,54,Leicht bewölkt,12,13,0.6,
,2021-07-08 02:00:00,15,2,13,Mäßiger Regenfall,13,13,0.3,
,2021-07-08 03:00:00,12,5,7,Mäßiger Regenfall,14,14,0.4,
,2021-07-08 04:00:00,5,1,4,Mäßiger Regenfall,14,14,0.2,
,2021-07-08 05:00:00,35,19,16,Nieselregen,15,15,0,
,2021-07-08 06:00:00,152,88,64,Nieselregen,15,15,0,
,2021-07-08 07:00:00,573,340,233,Nieselregen,16,16,0,
,2021-07-08 08:00:00,540,277,263,Leichter Nebel,16,16,0,
,2021-07-08 09:00:00,464,273,191,Leichter Nebel,17,17,0,
,2021-07-08 10:00:00,252,134,118,Leichter Nebel,17,17,0,
,2021-07-08 11:00:00,288,137,151,Stellenweiser Regenfall,17,17,0,
,2021-07-08 12:00:00,353,141,212,Stellenweiser Regenfall,17,17,0,
,2021-07-08 13:00:00,406,142,264,Stellenweiser Regenfall,16,16,0,
,2021-07-08 14:00:00,463,217,246,Bewölkt,16,16,0.3,
,2021-07-08 15:00:00,659,340,319,Bewölkt,16,16,0.4,
,2021-07-08 16:00:00,727,382,345,Bewölkt,15,15,0.2,
,2021-07-08 17:00:00,749,369,380,Leichter Regenschauer,15,15,1.2,
,2021-07-08 18:00:00,504,199,305,Leichter Regenschauer,15,14,1.6,
,2021-07-08 19:00:00,284,106,178,Leichter Regenschauer,14,14,0.8,
,2021-07-08 20:00:00,205,81,124,Mäßiger Regenfall,14,14,1.2,
,2021-07-08 21:00:00,120,57,63,Mäßiger Regenfall,14,13,1.6,
,2021-07-08 22:00:00,92,24,68,Mäßiger Regenfall,13,13,0.8,
,2021-07-08 23:00:00,67,23,44,Mäßiger Regenfall,13,13,0.7,
,2021-07-09 00:00:00,34,12,22,Mäßiger Regenfall,13,13,1.5,
,2021-07-09 01:00:00,22,11,11,Mäßiger Regenfall,13,13,0.7,
,2021-07-09 02:00:00,11,2,9,Leichter Nebel,14,14,0.3,
,2021-07-09 03:00:00,3,0,3,Leichter Nebel,14,14,0.4,
,2021-07-09 04:00:00,7,7,0,Leichter Nebel,14,14,0.2,
,2021-07-09 05:00:00,26,16,10,Leichter Regenfall,14,14,0.1,
,2021-07-09 06:00:00,153,89,64,Leichter Regenfall,14,14,0.2,
,2021-07-09 07:00:00,774,523,251,Leichter Regenfall,15,15,0.1,
,2021-07-09 08:00:00,656,367,289,Leichter Nebel,15,15,0.2,
,2021-07-09 09:00:00,669,389,280,Leichter Nebel,16,16,0.2,
,2021-07-09 10:00:00,571,342,229,Leichter Nebel,17,17,0.1,
,2021-07-09 11:00:00,716,358,358,Leichter Regenschauer,19,19,0.1,
,2021-07-09 12:00:00,876,384,492,Leichter Regenschauer,20,20,0.1,
,2021-07-09 13:00:00,932,385,547,Leichter Regenschauer,21,21,0,
,2021-07-09 14:00:00,892,447,445,Leicht bewölkt,22,22,0,
,2021-07-09 15:00:00,930,442,488,Leicht bewölkt,23,25,0,
,2021-07-09 16:00:00,902,436,466,Leicht bewölkt,22,24,0,
,2021-07-09 17:00:00,965,474,491,Leicht bewölkt,22,22,0,
,2021-07-09 18:00:00,925,463,462,Leicht bewölkt,21,21,0,
,2021-07-09 19:00:00,727,404,323,Leicht bewölkt,20,20,0,
,2021-07-09 20:00:00,650,312,338,Leicht bewölkt,19,19,0,
,2021-07-09 21:00:00,507,225,282,Leicht bewölkt,17,17,0,
,2021-07-09 22:00:00,363,149,214,Leicht bewölkt,16,16,0,
,2021-07-09 23:00:00,330,121,209,Leicht bewölkt,14,14,0,
,2021-07-10 00:00:00,251,78,173,Leicht bewölkt,13,13,0,
,2021-07-10 01:00:00,158,48,110,Leicht bewölkt,12,12,0,
,2021-07-10 02:00:00,124,31,93,Leicht bewölkt,12,12,0,
,2021-07-10 03:00:00,100,34,66,Leicht bewölkt,11,11,0,
,2021-07-10 04:00:00,34,15,19,Leicht bewölkt,12,12,0,
,2021-07-10 05:00:00,36,22,14,Leicht bewölkt,13,13,0,
,2021-07-10 06:00:00,85,51,34,Leicht bewölkt,14,14,0,
,2021-07-10 07:00:00,99,54,45,Leicht bewölkt,16,16,0,
,2021-07-10 08:00:00,322,173,149,Leicht bewölkt,18,18,0,
,2021-07-10 09:00:00,587,359,228,Leicht bewölkt,19,19,0,
,2021-07-10 10:00:00,741,392,349,Leicht bewölkt,20,20,0,
,2021-07-10 11:00:00,751,408,343,Leicht bewölkt,21,21,0,
,2021-07-10 12:00:00,813,418,395,Leicht bewölkt,22,24,0,
,2021-07-10 13:00:00,794,377,417,Leicht bewölkt,23,24,0,
,2021-07-10 14:00:00,816,403,413,Leicht bewölkt,24,25,0,
,2021-07-10 15:00:00,832,401,431,Leicht bewölkt,24,26,0,
,2021-07-10 16:00:00,768,368,400,Leicht bewölkt,24,25,0,
,2021-07-10 17:00:00,816,422,394,Leicht bewölkt,23,25,0,
,2021-07-10 18:00:00,801,393,408,Leicht bewölkt,23,25,0,
,2021-07-10 19:00:00,683,352,331,Leicht bewölkt,22,22,0,
,2021-07-10 20:00:00,593,284,309,Leicht bewölkt,21,21,0.1,
,2021-07-10 21:00:00,607,248,359,Leicht bewölkt,20,20,0.1,
,2021-07-10 22:00:00,352,159,193,Leicht bewölkt,19,19,0,
,2021-07-10 23:00:00,148,40,108,Leichter Regenschauer,17,17,0.1,
,2021-07-11 00:00:00,167,40,127,Leichter Regenschauer,16,16,0.2,
,2021-07-11 01:00:00,87,24,63,Leichter Regenschauer,15,15,0.1,
,2021-07-11 02:00:00,91,22,69,Bedeckt,15,15,0,
,2021-07-11 03:00:00,83,27,56,Bedeckt,15,15,0,
,2021-07-11 04:00:00,29,5,24,Bedeckt,15,15,0,
,2021-07-11 05:00:00,30,18,12,Leichter Regenschauer,16,16,0,
,2021-07-11 06:00:00,41,28,13,Leichter Regenschauer,16,16,0,
,2021-07-11 07:00:00,67,27,40,Leichter Regenschauer,18,18,0,
,2021-07-11 08:00:00,133,54,79,Bewölkt,19,19,0,
,2021-07-11 09:00:00,292,145,147,Bewölkt,20,20,0,
,2021-07-11 10:00:00,369,181,188,Bewölkt,21,21,0,
,2021-07-11 11:00:00,441,233,208,Stellenweiser Regenfall,22,24,0,
,2021-07-11 12:00:00,500,238,262,Stellenweiser Regenfall,23,25,0,
,2021-07-11 13:00:00,596,300,296,Stellenweiser Regenfall,24,25,0,
,2021-07-11 14:00:00,675,352,323,Leicht bewölkt,24,26,0,
,2021-07-11 15:00:00,616,341,275,Leicht bewölkt,25,26,0,
,2021-07-11 16:00:00,643,313,330,Leicht bewölkt,24,26,0,
,2021-07-11 17:00:00,692,356,336,Leicht bewölkt,24,25,0,
,2021-07-11 18:00:00,621,292,329,Leicht bewölkt,23,25,0,
,2021-07-11 19:00:00,653,342,311,Leicht bewölkt,23,25,0,
,2021-07-11 20:00:00,637,318,319,Leicht bewölkt,22,22,0,
,2021-07-11 21:00:00,295,111,184,Leicht bewölkt,21,21,0,
,2021-07-11 22:00:00,147,48,99,Leicht bewölkt,20,20,0,
,2021-07-11 23:00:00,114,44,70,Leicht bewölkt,18,18,0,
,2021-07-12 00:00:00,374,136,238,Leicht bewölkt,17,17,0,
,2021-07-12 01:00:00,65,16,49,Leicht bewölkt,16,16,0,
,2021-07-12 02:00:00,14,6,8,Leicht bewölkt,15,16,0,
,2021-07-12 03:00:00,4,4,0,Leicht bewölkt,15,15,0,
,2021-07-12 04:00:00,7,4,3,Leicht bewölkt,16,16,0,
,2021-07-12 05:00:00,50,32,18,Leicht bewölkt,17,17,0,
,2021-07-12 06:00:00,210,127,83,Leicht bewölkt,18,18,0,
,2021-07-12 07:00:00,676,343,333,Leicht bewölkt,20,20,0,
,2021-07-12 08:00:00,837,488,349,Leicht bewölkt,21,21,0,
,2021-07-12 09:00:00,667,381,286,Leicht bewölkt,23,24,0,
,2021-07-12 10:00:00,648,369,279,Leicht bewölkt,25,26,0,
,2021-07-12 11:00:00,676,355,321,Leicht bewölkt,26,27,0,
,2021-07-12 12:00:00,863,391,472,Leicht bewölkt,28,29,0,
,2021-07-12 13:00:00,909,453,456,Leicht bewölkt,28,29,0,
,2021-07-12 14:00:00,887,471,416,Leicht bewölkt,28,30,0,
,2021-07-12 15:00:00,1058,525,533,Leicht bewölkt,29,31,0,
,2021-07-12 16:00:00,1032,505,527,Leicht bewölkt,28,30,0,
,2021-07-12 17:00:00,1115,509,606,Leicht bewölkt,27,30,0.2,
,2021-07-12 18:00:00,1046,473,573,Leicht bewölkt,27,30,0.3,
,2021-07-12 19:00:00,789,367,422,Leicht bewölkt,26,29,0.2,
,2021-07-12 20:00:00,550,250,300,Nieselregen mit Gewitter,25,29,0.3,
,2021-07-12 21:00:00,426,183,243,Nieselregen mit Gewitter,24,28,0.4,
,2021-07-12 22:00:00,258,90,168,Nieselregen mit Gewitter,22,25,0.2,
,2021-07-12 23:00:00,145,50,95,Leichter Regenschauer,20,20,0.1,
,2021-07-13 00:00:00,63,29,34,Leichter Regenschauer,18,18,0.2,
,2021-07-13 01:00:00,32,11,21,Leichter Regenschauer,17,17,0.1,
,2021-07-13 02:00:00,16,7,9,Leichter Nebel,16,16,0.4,
,2021-07-13 03:00:00,6,4,2,Leichter Nebel,15,15,0.5,
,2021-07-13 04:00:00,7,5,2,Leichter Nebel,15,15,0.3,
,2021-07-13 05:00:00,42,24,18,Leichter Regenschauer,15,15,0.8,
,2021-07-13 06:00:00,128,77,51,Leichter Regenschauer,16,16,1,
,2021-07-13 07:00:00,312,125,187,Leichter Regenschauer,15,15,0.5,
,2021-07-13 08:00:00,559,323,236,Mäßiger Regenfall,15,14,0.6,
,2021-07-13 09:00:00,391,236,155,Mäßiger Regenfall,14,13,0.8,
,2021-07-13 10:00:00,226,108,118,Mäßiger Regenfall,14,13,0.4,
,2021-07-13 11:00:00,225,125,100,Leichter Regenfall,13,12,0.7,
,2021-07-13 12:00:00,351,166,185,Leichter Regenfall,13,12,0.9,
,2021-07-13 13:00:00,390,181,209,Leichter Regenfall,13,12,0.4,
,2021-07-13 14:00:00,449,238,211,Leichter Regenfall,13,13,0.3,
,2021-07-13 15:00:00,550,303,247,Leichter Regenfall,13,13,0.4,
,2021-07-13 16:00:00,648,319,329,Leichter Regenfall,13,13,0.2,
,2021-07-13 17:00:00,647,310,337,Nieselregen,13,13,0,
,2021-07-13 18:00:00,717,320,397,Nieselregen,13,13,0,
,2021-07-13 19:00:00,526,246,280,Nieselregen,13,13,0,
,2021-07-13 20:00:00,416,205,211,Leichter Nebel,13,13,0.4,
,2021-07-13 21:00:00,276,121,155,Leichter Nebel,13,13,0.5,
,2021-07-13 22:00:00,204,90,114,Leichter Nebel,13,13,0.2,
,2021-07-13 23:00:00,116,40,76,Leichter Regenfall,13,13,1.1,
,2021-07-14 00:00:00,62,30,32,Leichter Regenfall,13,13,2.3,
,2021-07-14 01:00:00,46,15,31,Leichter Regenfall,13,13,1.1,
,2021-07-14 02:00:00,11,7,4,Mäßiger Regenfall,13,13,2.7,
,2021-07-14 03:00:00,14,9,5,Mäßiger Regenfall,13,13,3.6,
,2021-07-14 04:00:00,7,5,2,Mäßiger Regenfall,13,13,1.8,
,2021-07-14 05:00:00,46,32,14,Starker Regenfall,13,13,4.8,
,2021-07-14 06:00:00,154,95,59,Starker Regenfall,13,13,6.4,
,2021-07-14 07:00:00,768,486,282,Starker Regenfall,13,13,3.2,
,2021-07-14 08:00:00,739,434,305,Starker Regenfall,13,12,2.4,
,2021-07-14 09:00:00,527,305,222,Starker Regenfall,13,12,3.2,
,2021-07-14 10:00:00,516,292,224,Starker Regenfall,13,12,1.6,
,2021-07-14 11:00:00,529,276,253,Mäßiger Regenfall,13,12,0.3,
,2021-07-14 12:00:00,691,320,371,Mäßiger Regenfall,13,12,0.4,
,2021-07-14 13:00:00,902,390,512,Mäßiger Regenfall,13,12,0.2,
,2021-07-14 14:00:00,761,371,390,Bewölkt,13,12,0.6,
,2021-07-14 15:00:00,845,372,473,Bewölkt,13,12,0.8,
,2021-07-14 16:00:00,1025,485,540,Bewölkt,13,12,0.4,
,2021-07-14 17:00:00,850,391,459,Mäßiger Regenfall,13,12,2.1,
,2021-07-14 18:00:00,848,381,467,Mäßiger Regenfall,13,12,2.8,
,2021-07-14 19:00:00,591,232,359,Mäßiger Regenfall,13,12,1.4,
,2021-07-14 20:00:00,411,187,224,Starker Regenfall,13,12,2.8,
,2021-07-14 21:00:00,254,107,147,Starker Regenfall,13,12,3.7,
,2021-07-14 22:00:00,206,82,124,Starker Regenfall,13,12,1.8,
,2021-07-14 23:00:00,112,45,67,Mäßiger Regenfall,14,12,0.9,
,2021-07-15 00:00:00,74,22,52,Mäßiger Regenfall,14,12,1.8,
,2021-07-15 01:00:00,36,11,25,Mäßiger Regenfall,14,12,0.9,
,2021-07-15 02:00:00,12,4,8,Nieselregen,14,12,1.5,
,2021-07-15 03:00:00,4,2,2,Nieselregen,14,12,2,
,2021-07-15 04:00:00,5,3,2,Nieselregen,14,13,1,
,2021-07-15 05:00:00,25,15,10,Mäßiger Regenfall,14,13,1.3,
,2021-07-15 06:00:00,112,55,57,Mäßiger Regenfall,14,13,1.8,
,2021-07-15 07:00:00,651,425,226,Mäßiger Regenfall,14,13,0.9,
,2021-07-15 08:00:00,620,365,255,Mäßiger Regenfall,14,13,0.8,
,2021-07-15 09:00:00,552,329,223,Mäßiger Regenfall,15,13,1,
,2021-07-15 10:00:00,396,224,172,Mäßiger Regenfall,15,13,0.5,
,2021-07-15 11:00:00,479,231,248,Leichter Regenfall,15,13,0.6,
,2021-07-15 12:00:00,585,288,297,Leichter Regenfall,15,13,0.8,
,2021-07-15 13:00:00,687,293,394,Leichter Regenfall,15,14,0.4,
,2021-07-15 14:00:00,590,279,311,Leichter Regenfall,15,14,0.4,
,2021-07-15 15:00:00,608,267,341,Leichter Regenfall,15,14,0.5,
,2021-07-15 16:00:00,657,320,337,Leichter Regenfall,15,14,0.3,
,2021-07-15 17:00:00,745,351,394,Leichter Regenfall,15,14,0.6,
,2021-07-15 18:00:00,689,297,392,Leichter Regenfall,15,14,0.8,
,2021-07-15 19:00:00,478,224,254,Leichter Regenfall,14,13,0.4,
,2021-07-15 20:00:00,342,148,194,Leichter Regenfall,14,13,0.3,
,2021-07-15 21:00:00,198,85,113,Leichter Regenfall,14,13,0.4,
,2021-07-15 22:00:00,191,88,103,Leichter Regenfall,13,13,0.2,
,2021-07-15 23:00:00,120,40,80,Leichter Regenschauer,12,12,0.3,
,2021-07-16 00:00:00,71,23,48,Leichter Regenschauer,12,12,0.5,
,2021-07-16 01:00:00,56,19,37,Leichter Regenschauer,12,12,0.3,
,2021-07-16 02:00:00,30,19,11,Nieselregen,13,13,0.1,
,2021-07-16 03:00:00,17,11,6,Nieselregen,14,14,0.2,
,2021-07-16 04:00:00,12,4,8,Nieselregen,14,14,0.1,
,2021-07-16 05:00:00,25,16,9,Leichter Regenschauer,14,14,0.2,
,2021-07-16 06:00:00,138,83,55,Leichter Regenschauer,14,14,0.3,
,2021-07-16 07:00:00,771,524,247,Leichter Regenschauer,14,15,0.1,
,2021-07-16 08:00:00,751,454,297,Leichter Regenschauer,15,15,0.2,
,2021-07-16 09:00:00,647,409,238,Leichter Regenschauer,16,16,0.2,
,2021-07-16 10:00:00,485,284,201,Leichter Regenschauer,16,17,0.1,
,2021-07-16 11:00:00,613,327,286,Leichter Regenschauer,17,17,0.2,
,2021-07-16 12:00:00,811,341,470,Leichter Regenschauer,18,18,0.3,
,2021-07-16 13:00:00,953,401,552,Leichter Regenschauer,19,19,0.2,
,2021-07-16 14:00:00,777,392,385,Leichter Regenschauer,19,19,0.2,
,2021-07-16 15:00:00,881,453,428,Leichter Regenschauer,20,20,0.3,
,2021-07-16 16:00:00,867,433,434,Leichter Regenschauer,20,20,0.1,
,2021-07-16 17:00:00,935,457,478,Stellenweiser Regenfall,20,20,0.1,
,2021-07-16 18:00:00,770,378,392,Stellenweiser Regenfall,19,19,0.2,
,2021-07-16 19:00:00,723,350,373,Stellenweiser Regenfall,18,18,0.1,
,2021-07-16 20:00:00,556,282,274,Stellenweiser Regenfall,17,17,0.1,
,2021-07-16 21:00:00,417,199,218,Stellenweiser Regenfall,15,15,0.2,
,2021-07-16 22:00:00,310,129,181,Stellenweiser Regenfall,14,14,0.1,
,2021-07-16 23:00:00,282,115,167,Leichter Regenschauer,13,13,0.2,
,2021-07-17 00:00:00,194,69,125,Leichter Regenschauer,12,12,0.4,
,2021-07-17 01:00:00,139,42,97,Leichter Regenschauer,12,12,0.2,
,2021-07-17 02:00:00,98,23,75,Leichter Regenschauer,12,12,0.1,
,2021-07-17 03:00:00,63,17,46,Leichter Regenschauer,12,12,0.1,
,2021-07-17 04:00:00,29,10,19,Leichter Regenschauer,12,13,0,
,2021-07-17 05:00:00,41,19,22,Leichter Nebel,13,14,0,
,2021-07-17 06:00:00,65,34,31,Leichter Nebel,14,14,0,
,2021-07-17 07:00:00,107,48,59,Leichter Nebel,15,15,0,
,2021-07-17 08:00:00,220,117,103,Leichter Nebel,16,16,0,
,2021-07-17 09:00:00,371,209,162,Leichter Nebel,17,17,0,
,2021-07-17 10:00:00,484,275,209,Leichter Nebel,18,18,0,
,2021-07-17 11:00:00,583,330,253,Leichter Regenschauer,18,18,0.3,
,2021-07-17 12:00:00,624,337,287,Leichter Regenschauer,19,19,0.4,
,2021-07-17 13:00:00,625,348,277,Leichter Regenschauer,19,19,0.2,
,2021-07-17 14:00:00,707,350,357,Leichter Regenschauer,20,20,0.6,
,2021-07-17 15:00:00,744,337,407,Leichter Regenschauer,20,20,0.8,
,2021-07-17 16:00:00,596,272,324,Leichter Regenschauer,20,20,0.4,
,2021-07-17 17:00:00,685,300,385,Stellenweiser Regenfall,19,19,1.1,
,2021-07-17 18:00:00,569,271,298,Stellenweiser Regenfall,19,19,1.4,
,2021-07-17 19:00:00,474,216,258,Stellenweiser Regenfall,18,18,0.7,
,2021-07-17 20:00:00,370,204,166,Mäßiger bis starker Regenschauer,17,17,0.5,
,2021-07-17 21:00:00,299,150,149,Mäßiger bis starker Regenschauer,16,16,0.7,
,2021-07-17 22:00:00,176,59,117,Mäßiger bis starker Regenschauer,16,16,0.4,
,2021-07-17 23:00:00,170,55,115,Leichter Regenschauer,16,16,1.1,
,2021-07-18 00:00:00,165,44,121,Leichter Regenschauer,16,16,2.2,
,2021-07-18 01:00:00,118,41,77,Leichter Regenschauer,16,16,1.1,
,2021-07-18 02:00:00,67,27,40,Mäßiger bis starker Regenschauer,15,15,0.5,
,2021-07-18 03:00:00,67,21,46,Mäßiger bis starker Regenschauer,15,15,0.6,
,2021-07-18 04:00:00,27,11,16,Mäßiger bis starker Regenschauer,16,16,0.3,
,2021-07-18 05:00:00,16,8,8,Leichter Regenschauer,16,16,0.1,
,2021-07-18 06:00:00,62,34,28,Leichter Regenschauer,16,16,0.2,
,2021-07-18 07:00:00,56,28,28,Leichter Regenschauer,17,17,0.1,
,2021-07-18 08:00:00,140,78,62,Leichter Regenschauer,18,18,0.1,
,2021-07-18 09:00:00,289,169,120,Leichter Regenschauer,18,18,0.1,
,2021-07-18 10:00:00,421,225,196,Leichter Regenschauer,20,20,0,
,2021-07-18 11:00:00,565,267,298,Stellenweiser Regenfall,21,21,0,
,2021-07-18 12:00:00,529,229,300,Stellenweiser Regenfall,22,22,0,
,2021-07-18 13:00:00,622,318,304,Stellenweiser Regenfall,22,24,0,
,2021-07-18 14:00:00,671,330,341,Stellenweiser Regenfall,23,24,0,
,2021-07-18 15:00:00,633,325,308,Stellenweiser Regenfall,23,25,0,
,2021-07-18 16:00:00,672,354,318,Stellenweiser Regenfall,22,24,0,
,2021-07-18 17:00:00,677,364,313,Leicht bewölkt,21,21,0,
,2021-07-18 18:00:00,627,302,325,Leicht bewölkt,20,20,0,
,2021-07-18 19:00:00,605,287,318,Leicht bewölkt,19,19,0,
,2021-07-18 20:00:00,474,210,264,Leicht bewölkt,18,17,0,
,2021-07-18 21:00:00,343,147,196,Leicht bewölkt,16,16,0,
,2021-07-18 22:00:00,210,85,125,Leicht bewölkt,15,15,0,
,2021-07-18 23:00:00,95,38,57,Leicht bewölkt,15,14,0,
,2021-07-19 00:00:00,66,30,36,Leicht bewölkt,14,14,0,
,2021-07-19 01:00:00,29,13,16,Leicht bewölkt,13,13,0,
,2021-07-19 02:00:00,17,6,11,Leicht bewölkt,13,13,0,
,2021-07-19 03:00:00,10,6,4,Leicht bewölkt,13,13,0,
,2021-07-19 04:00:00,11,7,4,Leicht bewölkt,13,13,0,
,2021-07-19 05:00:00,61,32,29,Leichter Nebel,14,14,0,
,2021-07-19 06:00:00,200,113,87,Leichter Nebel,15,15,0,
,2021-07-19 07:00:00,1033,659,374,Leichter Nebel,16,16,0,
,2021-07-19 08:00:00,857,506,351,Leicht bewölkt,18,18,0,
,2021-07-19 09:00:00,726,396,330,Leicht bewölkt,19,19,0,
,2021-07-19 10:00:00,602,316,286,Leicht bewölkt,21,21,0,
,2021-07-19 11:00:00,692,353,339,Leicht bewölkt,22,22,0,
,2021-07-19 12:00:00,883,352,531,Leicht bewölkt,23,24,0,
,2021-07-19 13:00:00,1051,480,571,Leicht bewölkt,23,24,0,
,2021-07-19 14:00:00,1009,526,483,Leicht bewölkt,24,25,0,
,2021-07-19 15:00:00,1126,536,590,Leicht bewölkt,24,25,0,
,2021-07-19 16:00:00,1176,564,612,Leicht bewölkt,23,25,0,
,2021-07-19 17:00:00,1240,628,612,Leicht bewölkt,23,24,0,
,2021-07-19 18:00:00,1119,488,631,Leicht bewölkt,22,24,0,
,2021-07-19 19:00:00,844,393,451,Leicht bewölkt,21,21,0,
,2021-07-19 20:00:00,575,280,295,Leicht bewölkt,20,20,0.1,
,2021-07-19 21:00:00,485,189,296,Leicht bewölkt,18,18,0.1,
,2021-07-19 22:00:00,305,110,195,Leicht bewölkt,17,17,0.1,
,2021-07-19 23:00:00,158,60,98,Stellenweiser Regenfall,16,16,0.1,
,2021-07-20 00:00:00,76,23,53,Stellenweiser Regenfall,15,14,0.1,
,2021-07-20 01:00:00,59,13,46,Stellenweiser Regenfall,14,14,0.1,
,2021-07-20 02:00:00,25,13,12,Stellenweiser Regenfall,13,13,0,
,2021-07-20 03:00:00,26,10,16,Stellenweiser Regenfall,12,12,0,
,2021-07-20 04:00:00,11,7,4,Stellenweiser Regenfall,13,13,0,
,2021-07-20 05:00:00,62,39,23,Leichter Nebel,14,14,0,
,2021-07-20 06:00:00,233,134,99,Leichter Nebel,14,14,0,
,2021-07-20 07:00:00,1053,682,371,Leichter Nebel,16,16,0,
,2021-07-20 08:00:00,961,552,409,Leicht bewölkt,17,17,0,
,2021-07-20 09:00:00,795,454,341,Leicht bewölkt,18,18,0,
,2021-07-20 10:00:00,663,370,293,Leicht bewölkt,19,19,0,
,2021-07-20 11:00:00,841,392,449,Leicht bewölkt,20,20,0,
,2021-07-20 12:00:00,1063,412,651,Leicht bewölkt,22,22,0,
,2021-07-20 13:00:00,1031,462,569,Leicht bewölkt,22,22,0,
,2021-07-20 14:00:00,966,492,474,Leicht bewölkt,22,24,0,
,2021-07-20 15:00:00,1309,634,675,Leicht bewölkt,23,25,0,
,2021-07-20 16:00:00,1234,618,616,Leicht bewölkt,22,22,0,
,2021-07-20 17:00:00,1292,631,661,Leicht bewölkt,21,21,0,
,2021-07-20 18:00:00,1273,613,660,Leicht bewölkt,20,20,0,
,2021-07-20 19:00:00,977,485,492,Leicht bewölkt,19,19,0,
,2021-07-20 20:00:00,690,317,373,Leicht bewölkt,17,17,0,
,2021-07-20 21:00:00,538,183,355,Leicht bewölkt,16,16,0,
,2021-07-20 22:00:00,385,158,227,Leicht bewölkt,15,15,0,
,2021-07-20 23:00:00,216,52,164,Leicht bewölkt,15,15,0,
,2021-07-21 00:00:00,116,46,70,Leicht bewölkt,15,15,0,
,2021-07-21 01:00:00,50,13,37,Leicht bewölkt,14,14,0,
,2021-07-21 02:00:00,17,4,13,Leicht bewölkt,13,13,0,
,2021-07-21 03:00:00,11,5,6,Leicht bewölkt,13,13,0,
,2021-07-21 04:00:00,12,6,6,Leicht bewölkt,13,14,0,
,2021-07-21 05:00:00,70,40,30,Leichter Nebel,14,14,0,
,2021-07-21 06:00:00,197,106,91,Leichter Nebel,15,15,0,
,2021-07-21 07:00:00,1003,650,353,Leichter Nebel,17,17,0,
,2021-07-21 08:00:00,890,497,393,Leicht bewölkt,18,18,0,
,2021-07-21 09:00:00,776,465,311,Leicht bewölkt,20,20,0,
,2021-07-21 10:00:00,692,380,312,Leicht bewölkt,21,21,0,
,2021-07-21 11:00:00,769,356,413,Leicht bewölkt,22,22,0,
,2021-07-21 12:00:00,1086,479,607,Leicht bewölkt,23,25,0,
,2021-07-21 13:00:00,1142,520,622,Leicht bewölkt,23,25,0,
,2021-07-21 14:00:00,956,445,511,Leicht bewölkt,23,25,0,
,2021-07-21 15:00:00,1130,549,581,Leicht bewölkt,24,25,0,
,2021-07-21 16:00:00,1219,604,615,Leicht bewölkt,23,24,0,
,2021-07-21 17:00:00,1299,622,677,Leicht bewölkt,22,22,0,
,2021-07-21 18:00:00,1230,595,635,Leicht bewölkt,21,21,0,
,2021-07-21 19:00:00,895,426,469,Leicht bewölkt,20,20,0,
,2021-07-21 20:00:00,706,316,390,Leicht bewölkt,18,18,0,
,2021-07-21 21:00:00,539,201,338,Leicht bewölkt,17,17,0,
,2021-07-21 22:00:00,383,164,219,Leicht bewölkt,16,16,0,
,2021-07-21 23:00:00,239,83,156,Leicht bewölkt,15,15,0,
,2021-07-22 00:00:00,108,33,75,Leicht bewölkt,14,15,0,
,2021-07-22 01:00:00,88,31,57,Leicht bewölkt,14,14,0,
,2021-07-22 02:00:00,33,8,25,Leicht bewölkt,13,14,0,
,2021-07-22 03:00:00,15,6,9,Leicht bewölkt,13,13,0,
,2021-07-22 04:00:00,16,9,7,Leicht bewölkt,14,14,0,
,2021-07-22 05:00:00,64,30,34,Leichter Nebel,14,15,0,
,2021-07-22 06:00:00,187,102,85,Leichter Nebel,15,15,0,
,2021-07-22 07:00:00,1018,653,365,Leichter Nebel,17,17,0,
,2021-07-22 08:00:00,945,569,376,Leicht bewölkt,19,19,0,
,2021-07-22 09:00:00,735,411,324,Leicht bewölkt,20,20,0,
,2021-07-22 10:00:00,701,385,316,Leicht bewölkt,21,21,0,
,2021-07-22 11:00:00,820,420,400,Leicht bewölkt,22,24,0,
,2021-07-22 12:00:00,964,455,509,Leicht bewölkt,24,25,0,
,2021-07-22 13:00:00,1070,426,644,Leicht bewölkt,24,25,0,
,2021-07-22 14:00:00,1017,510,507,Leicht bewölkt,24,26,0,
,2021-07-22 15:00:00,1173,582,591,Leicht bewölkt,25,26,0,
,2021-07-22 16:00:00,1156,536,620,Leicht bewölkt,24,25,0,
,2021-07-22 17:00:00,1245,622,623,Leicht bewölkt,23,24,0,
,2021-07-22 18:00:00,1155,525,630,Leicht bewölkt,22,22,0,
,2021-07-22 19:00:00,930,474,456,Leicht bewölkt,20,20,0,
,2021-07-22 20:00:00,742,332,410,Leicht bewölkt,19,19,0,
,2021-07-22 21:00:00,575,218,357,Leicht bewölkt,18,18,0,
,2021-07-22 22:00:00,402,139,263,Leicht bewölkt,17,17,0,
,2021-07-22 23:00:00,214,74,140,Leicht bewölkt,16,16,0,
,2021-07-23 00:00:00,175,49,126,Leicht bewölkt,15,15,0,
,2021-07-23 01:00:00,77,29,48,Leicht bewölkt,15,15,0,
,2021-07-23 02:00:00,50,28,22,Leicht bewölkt,15,15,0,
,2021-07-23 03:00:00,26,11,15,Leicht bewölkt,14,14,0,
,2021-07-23 04:00:00,16,9,7,Leicht bewölkt,15,15,0,
,2021-07-23 05:00:00,81,42,39,Leicht bewölkt,16,16,0,
,2021-07-23 06:00:00,194,116,78,Leicht bewölkt,17,17,0,
,2021-07-23 07:00:00,952,647,305,Leicht bewölkt,18,18,0,
,2021-07-23 08:00:00,854,486,368,Leicht bewölkt,20,20,0,
,2021-07-23 09:00:00,911,513,398,Leicht bewölkt,22,22,0,
,2021-07-23 10:00:00,836,429,407,Leicht bewölkt,23,24,0,
,2021-07-23 11:00:00,921,442,479,Leicht bewölkt,24,25,0,
,2021-07-23 12:00:00,1095,479,616,Leicht bewölkt,25,27,0,
,2021-07-23 13:00:00,1132,491,641,Leicht bewölkt,26,27,0,
,2021-07-23 14:00:00,1114,517,597,Leicht bewölkt,26,27,0,
,2021-07-23 15:00:00,1064,502,562,Leicht bewölkt,26,27,0,
,2021-07-23 16:00:00,1004,490,514,Leicht bewölkt,26,27,0,
,2021-07-23 17:00:00,1000,508,492,Leicht bewölkt,25,26,0,
,2021-07-23 18:00:00,992,461,531,Leicht bewölkt,24,26,0,
,2021-07-23 19:00:00,892,469,423,Leicht bewölkt,23,24,0,
,2021-07-23 20:00:00,693,347,346,Leicht bewölkt,21,21,0,
,2021-07-23 21:00:00,603,266,337,Leicht bewölkt,20,20,0,
,2021-07-23 22:00:00,417,190,227,Leicht bewölkt,19,19,0,
,2021-07-23 23:00:00,375,142,233,Leicht bewölkt,18,18,0,
,2021-07-24 00:00:00,322,99,223,Leicht bewölkt,18,18,0,
,2021-07-24 01:00:00,218,57,161,Leicht bewölkt,17,17,0,
,2021-07-24 02:00:00,160,55,105,Leicht bewölkt,17,17,0,
,2021-07-24 03:00:00,100,31,69,Leicht bewölkt,17,17,0,
,2021-07-24 04:00:00,46,20,26,Leicht bewölkt,17,17,0,
,2021-07-24 05:00:00,50,25,25,Leicht bewölkt,18,18,0,
,2021-07-24 06:00:00,95,50,45,Leicht bewölkt,19,19,0,
,2021-07-24 07:00:00,83,37,46,Leicht bewölkt,20,20,0,
,2021-07-24 08:00:00,168,92,76,Leicht bewölkt,21,21,0,
,2021-07-24 09:00:00,279,158,121,Leicht bewölkt,22,24,0,
,2021-07-24 10:00:00,430,233,197,Leicht bewölkt,24,25,0,
,2021-07-24 11:00:00,607,344,263,Bedeckt,25,26,0,
,2021-07-24 12:00:00,608,343,265,Bedeckt,26,27,0,
,2021-07-24 13:00:00,695,340,355,Bedeckt,27,28,0,
,2021-07-24 14:00:00,696,336,360,Leicht bewölkt,27,28,0,
,2021-07-24 15:00:00,686,335,351,Leicht bewölkt,27,29,0,
,2021-07-24 16:00:00,606,236,370,Leicht bewölkt,26,28,0,
,2021-07-24 17:00:00,355,143,212,Leicht bewölkt,26,28,0.4,
,2021-07-24 18:00:00,371,164,207,Leicht bewölkt,25,27,0.6,
,2021-07-24 19:00:00,314,169,145,Leicht bewölkt,24,26,0.3,
,2021-07-24 20:00:00,266,149,117,Leichter Regenschauer,22,25,0.2,
,2021-07-24 21:00:00,255,145,110,Leichter Regenschauer,21,21,0.3,
,2021-07-24 22:00:00,157,74,83,Leichter Regenschauer,20,20,0.2,
,2021-07-24 23:00:00,160,69,91,Stellenweiser leichter Regenfall,19,19,0.1,
,2021-07-25 00:00:00,133,43,90,Stellenweiser leichter Regenfall,17,17,0.3,
,2021-07-25 01:00:00,108,35,73,Stellenweiser leichter Regenfall,17,17,0.1,
,2021-07-25 02:00:00,70,21,49,Leicht bewölkt,16,16,0.1,
,2021-07-25 03:00:00,48,13,35,Leicht bewölkt,16,16,0.1,
,2021-07-25 04:00:00,32,9,23,Leicht bewölkt,16,16,0,
,2021-07-25 05:00:00,28,12,16,Leichter Regenschauer,17,17,0,
,2021-07-25 06:00:00,27,16,11,Leichter Regenschauer,17,17,0,
,2021-07-25 07:00:00,45,24,21,Leichter Regenschauer,18,18,0,
,2021-07-25 08:00:00,106,44,62,Leichter Nebel,19,19,0.2,
,2021-07-25 09:00:00,226,114,112,Leichter Nebel,21,21,0.2,
,2021-07-25 10:00:00,342,164,178,Leichter Nebel,22,22,0.1,
,2021-07-25 11:00:00,385,189,196,Nieselregen mit Gewitter,23,25,0.1,
,2021-07-25 12:00:00,446,228,218,Nieselregen mit Gewitter,24,26,0.1,
,2021-07-25 13:00:00,494,229,265,Nieselregen mit Gewitter,25,26,0,
,2021-07-25 14:00:00,243,82,161,Stellenweise Gewitter und Niederschläge,25,27,0,
,2021-07-25 15:00:00,312,176,136,Stellenweise Gewitter und Niederschläge,26,27,0,
,2021-07-25 16:00:00,380,185,195,Stellenweise Gewitter und Niederschläge,25,27,0,
,2021-07-25 17:00:00,340,157,183,Nieselregen mit Gewitter,24,26,0.2,
,2021-07-25 18:00:00,374,191,183,Nieselregen mit Gewitter,23,25,0.3,
,2021-07-25 19:00:00,264,138,126,Nieselregen mit Gewitter,21,21,0.2,
,2021-07-25 20:00:00,224,106,118,Nieselregen mit Gewitter,20,20,1.7,
,2021-07-25 21:00:00,228,101,127,Nieselregen mit Gewitter,18,18,2.2,
,2021-07-25 22:00:00,140,54,86,Nieselregen mit Gewitter,18,18,1.1,
,2021-07-25 23:00:00,103,35,68,Nieselregen mit Gewitter,17,17,0.9,
,2021-07-26 00:00:00,62,24,38,Nieselregen mit Gewitter,16,16,1.7,
,2021-07-26 01:00:00,27,14,13,Nieselregen mit Gewitter,16,16,0.9,
,2021-07-26 02:00:00,21,6,15,Mäßiger bis starker Regenschauer,15,15,0.9,
,2021-07-26 03:00:00,7,3,4,Mäßiger bis starker Regenschauer,15,15,1.2,
,2021-07-26 04:00:00,9,3,6,Mäßiger bis starker Regenschauer,15,15,0.6,
,2021-07-26 05:00:00,39,19,20,Stellenweiser Regenfall,16,16,0.2,
,2021-07-26 06:00:00,158,100,58,Stellenweiser Regenfall,16,16,0.3,
,2021-07-26 07:00:00,831,525,306,Stellenweiser Regenfall,17,17,0.2,
,2021-07-26 08:00:00,797,437,360,Leicht bewölkt,19,19,0,
,2021-07-26 09:00:00,677,394,283,Leicht bewölkt,20,20,0,
,2021-07-26 10:00:00,623,341,282,Leicht bewölkt,21,21,0,
,2021-07-26 11:00:00,636,336,300,Stellenweiser Regenfall,22,24,0,
,2021-07-26 12:00:00,787,370,417,Stellenweiser Regenfall,23,25,0,
,2021-07-26 13:00:00,1009,439,570,Stellenweiser Regenfall,23,24,0,
,2021-07-26 14:00:00,911,446,465,Stellenweise Gewitter und Niederschläge,22,23,0.9,
,2021-07-26 15:00:00,1036,498,538,Stellenweise Gewitter und Niederschläge,22,22,1.2,
,2021-07-26 16:00:00,898,416,482,Stellenweise Gewitter und Niederschläge,21,21,0.6,
,2021-07-26 17:00:00,733,342,391,Mäßiger bis starker Regenschauer,20,20,0.8,
,2021-07-26 18:00:00,790,324,466,Mäßiger bis starker Regenschauer,19,19,1,
,2021-07-26 19:00:00,546,261,285,Mäßiger bis starker Regenschauer,18,18,0.5,
,2021-07-26 20:00:00,376,177,199,Leichter Regenschauer,18,18,0.2,
,2021-07-26 21:00:00,263,116,147,Leichter Regenschauer,17,17,0.3,
,2021-07-26 22:00:00,167,81,86,Leichter Regenschauer,16,17,0.1,
,2021-07-26 23:00:00,132,54,78,Stellenweiser Regenfall,16,16,0.1,
,2021-07-27 00:00:00,77,31,46,Stellenweiser Regenfall,16,16,0.3,
,2021-07-27 01:00:00,59,18,41,Stellenweiser Regenfall,15,16,0.1,
,2021-07-27 02:00:00,21,10,11,Leichter Regenschauer,15,15,0.2,
,2021-07-27 03:00:00,13,3,10,Leichter Regenschauer,14,15,0.3,
,2021-07-27 04:00:00,13,6,7,Leichter Regenschauer,15,15,0.1,
,2021-07-27 05:00:00,54,28,26,Leichter Regenschauer,15,16,0.3,
,2021-07-27 06:00:00,209,117,92,Leichter Regenschauer,16,16,0.4,
,2021-07-27 07:00:00,788,442,346,Leichter Regenschauer,17,17,0.2,
,2021-07-27 08:00:00,1014,572,442,Leichter Regenschauer,18,18,0.3,
,2021-07-27 09:00:00,789,424,365,Leichter Regenschauer,18,18,0.4,
,2021-07-27 10:00:00,662,352,310,Leichter Regenschauer,18,18,0.2,
,2021-07-27 11:00:00,714,366,348,Leichter Regenschauer,18,18,0.5,
,2021-07-27 12:00:00,901,387,514,Leichter Regenschauer,18,18,0.7,
,2021-07-27 13:00:00,968,454,514,Leichter Regenschauer,18,18,0.4,
,2021-07-27 14:00:00,897,450,447,Leichter Regenschauer,18,18,0.3,
,2021-07-27 15:00:00,1070,528,542,Leichter Regenschauer,18,18,0.4,
,2021-07-27 16:00:00,1101,525,576,Leichter Regenschauer,18,18,0.2,
,2021-07-27 17:00:00,1157,545,612,Stellenweiser Nieselregen,17,17,0,
,2021-07-27 18:00:00,1171,507,664,Stellenweiser Nieselregen,17,17,0,
,2021-07-27 19:00:00,669,271,398,Stellenweiser Nieselregen,16,16,0,
,2021-07-27 20:00:00,429,207,222,Leichter Nebel,16,16,0.5,
,2021-07-27 21:00:00,274,132,142,Leichter Nebel,15,15,0.7,
,2021-07-27 22:00:00,187,75,112,Leichter Nebel,16,15,0.4,
,2021-07-27 23:00:00,133,56,77,Leichter Regenschauer,16,16,0.3,
,2021-07-28 00:00:00,83,30,53,Leichter Regenschauer,16,16,0.5,
,2021-07-28 01:00:00,67,19,48,Leichter Regenschauer,16,16,0.3,
,2021-07-28 02:00:00,39,15,24,Leichter Regenschauer,15,15,0.1,
,2021-07-28 03:00:00,19,3,16,Leichter Regenschauer,15,15,0.1,
,2021-07-28 04:00:00,12,8,4,Leichter Regenschauer,15,15,0,
,2021-07-28 05:00:00,57,31,26,Leichter Nebel,16,16,0,
,2021-07-28 06:00:00,168,99,69,Leichter Nebel,16,16,0,
,2021-07-28 07:00:00,757,445,312,Leichter Nebel,16,16,0,
,2021-07-28 08:00:00,690,381,309,Leichter Nebel,16,16,0.4,
,2021-07-28 09:00:00,478,306,172,Leichter Nebel,16,16,0.5,
,2021-07-28 10:00:00,532,168,364,Leichter Nebel,16,16,0.3,
,2021-07-28 11:00:00,463,281,182,Leichter Regenfall,17,17,0.2,
,2021-07-28 12:00:00,374,154,220,Leichter Regenfall,17,17,0.3,
,2021-07-28 13:00:00,464,215,249,Leichter Regenfall,18,18,0.1,
,2021-07-28 14:00:00,667,339,328,Leicht bewölkt,20,20,0,
,2021-07-28 15:00:00,738,355,383,Leicht bewölkt,21,21,0,
,2021-07-28 16:00:00,855,434,421,Leicht bewölkt,21,21,0,
,2021-07-28 17:00:00,948,451,497,Leicht bewölkt,21,21,0,
,2021-07-28 18:00:00,934,452,482,Leicht bewölkt,21,21,0,
,2021-07-28 19:00:00,761,365,396,Leicht bewölkt,20,20,0,
,2021-07-28 20:00:00,634,346,288,Leicht bewölkt,19,19,0,
,2021-07-28 21:00:00,470,227,243,Leicht bewölkt,17,17,0,
,2021-07-28 22:00:00,390,173,217,Leicht bewölkt,16,16,0,
,2021-07-28 23:00:00,251,87,164,Leicht bewölkt,15,15,0,
,2021-07-29 00:00:00,187,47,140,Leicht bewölkt,14,15,0,
,2021-07-29 01:00:00,133,38,95,Leicht bewölkt,14,14,0,
,2021-07-29 02:00:00,53,19,34,Leicht bewölkt,13,14,0,
,2021-07-29 03:00:00,42,12,30,Leicht bewölkt,13,13,0,
,2021-07-29 04:00:00,16,8,8,Leicht bewölkt,14,14,0,
,2021-07-29 05:00:00,67,39,28,Bewölkt,15,15,0,
,2021-07-29 06:00:00,192,106,86,Bewölkt,16,16,0,
,2021-07-29 07:00:00,444,251,193,Bewölkt,17,17,0,
,2021-07-29 08:00:00,764,407,357,Leicht bewölkt,19,19,0,
,2021-07-29 09:00:00,674,378,296,Leicht bewölkt,21,21,0,
,2021-07-29 10:00:00,729,378,351,Leicht bewölkt,22,22,0,
,2021-07-29 11:00:00,852,409,443,Leicht bewölkt,23,25,0,
,2021-07-29 12:00:00,917,428,489,Leicht bewölkt,24,26,0,
,2021-07-29 13:00:00,873,431,442,Leicht bewölkt,25,26,0,
,2021-07-29 14:00:00,932,441,491,Stellenweiser Regenfall,25,27,0,
,2021-07-29 15:00:00,908,474,434,Stellenweiser Regenfall,26,27,0,
,2021-07-29 16:00:00,1029,483,546,Stellenweiser Regenfall,25,27,0,
,2021-07-29 17:00:00,1118,572,546,Leicht bewölkt,24,26,0.4,
,2021-07-29 18:00:00,1048,483,565,Leicht bewölkt,24,26,0.5,
,2021-07-29 19:00:00,757,382,375,Leicht bewölkt,22,25,0.2,
,2021-07-29 20:00:00,678,305,373,Leichter Regenschauer,21,21,1.8,
,2021-07-29 21:00:00,531,226,305,Leichter Regenschauer,20,20,2.4,
,2021-07-29 22:00:00,343,125,218,Leichter Regenschauer,19,19,1.2,
,2021-07-29 23:00:00,225,91,134,Mäßiger Regenfall,18,18,2.5,
,2021-07-30 00:00:00,131,29,102,Mäßiger Regenfall,18,18,5,
,2021-07-30 01:00:00,74,15,59,Mäßiger Regenfall,17,17,2.5,
,2021-07-30 02:00:00,50,18,32,Starker Regenfall,16,16,1.2,
,2021-07-30 03:00:00,27,6,21,Starker Regenfall,15,16,1.6,
,2021-07-30 04:00:00,19,7,12,Starker Regenfall,16,16,0.8,
,2021-07-30 05:00:00,58,33,25,Leichter Regenschauer,16,16,0.4,
,2021-07-30 06:00:00,172,99,73,Leichter Regenschauer,16,17,0.6,
,2021-07-30 07:00:00,399,209,190,Leichter Regenschauer,18,18,0.3,
,2021-07-30 08:00:00,724,435,289,Leichter Regenschauer,19,19,0.2,
,2021-07-30 09:00:00,762,424,338,Leichter Regenschauer,20,20,0.2,
,2021-07-30 10:00:00,758,436,322,Leichter Regenschauer,22,22,0.1,
,2021-07-30 11:00:00,752,373,379,Leicht bewölkt,23,24,0,
,2021-07-30 12:00:00,871,386,485,Leicht bewölkt,24,26,0,
,2021-07-30 13:00:00,848,373,475,Leicht bewölkt,24,26,0,
,2021-07-30 14:00:00,869,398,471,Bewölkt,25,26,0,
,2021-07-30 15:00:00,881,478,403,Bewölkt,25,27,0,
,2021-07-30 16:00:00,904,415,489,Bewölkt,25,27,0,
,2021-07-30 17:00:00,940,428,512,Nieselregen mit Gewitter,25,27,0.5,
,2021-07-30 18:00:00,544,257,287,Nieselregen mit Gewitter,24,27,0.7,
,2021-07-30 19:00:00,433,206,227,Nieselregen mit Gewitter,23,26,0.3,
,2021-07-30 20:00:00,337,153,184,Nieselregen mit Gewitter,22,25,0.4,
,2021-07-30 21:00:00,240,118,122,Nieselregen mit Gewitter,21,21,0.5,
,2021-07-30 22:00:00,202,86,116,Nieselregen mit Gewitter,20,20,0.3,
,2021-07-30 23:00:00,146,48,98,Mäßiger bis starker Regenschauer,19,19,3.3,
,2021-07-31 00:00:00,116,35,81,Mäßiger bis starker Regenschauer,18,18,6.5,
,2021-07-31 01:00:00,109,38,71,Mäßiger bis starker Regenschauer,17,17,3.3,
,2021-07-31 02:00:00,75,28,47,Teilweise starker Regenfall,16,16,1.3,
,2021-07-31 03:00:00,48,11,37,Teilweise starker Regenfall,15,15,1.8,
,2021-07-31 04:00:00,39,12,27,Teilweise starker Regenfall,15,15,0.9,
,2021-07-31 05:00:00,38,19,19,Leichter Regenschauer,15,15,0.1,
,2021-07-31 06:00:00,55,35,20,Leichter Regenschauer,16,16,0.2,
,2021-07-31 07:00:00,85,36,49,Leichter Regenschauer,17,17,0.1,
,2021-07-31 08:00:00,194,105,89,Leichter Regenschauer,18,18,0,
,2021-07-31 09:00:00,378,211,167,Leichter Regenschauer,19,19,0,
,2021-07-31 10:00:00,586,323,263,Leichter Regenschauer,20,20,0,
,2021-07-31 11:00:00,627,345,282,Leicht bewölkt,21,21,0,
,2021-07-31 12:00:00,671,357,314,Leicht bewölkt,22,22,0,
,2021-07-31 13:00:00,746,360,386,Leicht bewölkt,22,22,0,
,2021-07-31 14:00:00,749,412,337,Leicht bewölkt,22,22,0,
,2021-07-31 15:00:00,699,347,352,Leicht bewölkt,22,25,0,
,2021-07-31 16:00:00,703,351,352,Leicht bewölkt,21,21,0,
,2021-07-31 17:00:00,700,350,350,Stellenweise Gewitter und Niederschläge,21,21,0.1,
,2021-07-31 18:00:00,718,321,397,Stellenweise Gewitter und Niederschläge,20,20,0.1,
,2021-07-31 19:00:00,541,266,275,Stellenweise Gewitter und Niederschläge,19,19,0.1,
,2021-07-31 20:00:00,406,205,201,Stellenweiser Regenfall,18,18,0.2,
,2021-07-31 21:00:00,341,148,193,Stellenweiser Regenfall,17,17,0.2,
,2021-07-31 22:00:00,218,80,138,Stellenweiser Regenfall,16,16,0.1,
,2021-07-31 23:00:00,186,68,118,Mäßiger Regenfall,15,15,2.7,
,2021-08-01 00:00:00,125,43,82,Mäßiger Regenfall,14,14,5.5,
,2021-08-01 01:00:00,91,34,57,Mäßiger Regenfall,14,14,2.7,
,2021-08-01 02:00:00,69,17,52,Starker Regenfall,14,13,4.3,
,2021-08-01 03:00:00,62,9,53,Starker Regenfall,14,13,5.8,
,2021-08-01 04:00:00,31,11,20,Starker Regenfall,14,13,2.9,
,2021-08-01 05:00:00,18,8,10,Starker Regenfall,14,13,6.6,
,2021-08-01 06:00:00,31,21,10,Starker Regenfall,14,14,8.8,
,2021-08-01 07:00:00,28,10,18,Starker Regenfall,14,14,4.4,
,2021-08-01 08:00:00,52,25,27,Starker Regenfall,14,14,2.6,
,2021-08-01 09:00:00,123,50,73,Starker Regenfall,14,14,3.5,
,2021-08-01 10:00:00,105,49,56,Starker Regenfall,14,14,1.8,
,2021-08-01 11:00:00,113,56,57,Nieselregen,14,14,0.1,
,2021-08-01 12:00:00,154,70,84,Nieselregen,14,15,0.1,
,2021-08-01 13:00:00,112,56,56,Nieselregen,15,15,0,
,2021-08-01 14:00:00,151,70,81,Leichter Nebel,15,15,0.1,
,2021-08-01 15:00:00,238,116,122,Leichter Nebel,15,15,0.1,
,2021-08-01 16:00:00,280,137,143,Leichter Nebel,14,14,0.1,
,2021-08-01 17:00:00,286,141,145,Nieselregen,14,14,0,
,2021-08-01 18:00:00,296,160,136,Nieselregen,13,13,0,
,2021-08-01 19:00:00,233,126,107,Nieselregen,13,13,0,
,2021-08-01 20:00:00,224,108,116,Leicht bewölkt,12,12,0,
,2021-08-01 21:00:00,165,58,107,Leicht bewölkt,12,12,0,
,2021-08-01 22:00:00,116,45,71,Leicht bewölkt,12,12,0,
,2021-08-01 23:00:00,74,33,41,Mäßiger bis starker Regenschauer,12,12,1.6,
,2021-08-02 00:00:00,47,15,32,Mäßiger bis starker Regenschauer,13,13,3.3,
,2021-08-02 01:00:00,18,7,11,Mäßiger bis starker Regenschauer,12,12,1.6,
,2021-08-02 02:00:00,4,2,2,Mäßiger bis starker Regenschauer,12,12,0.8,
,2021-08-02 03:00:00,7,3,4,Mäßiger bis starker Regenschauer,12,12,1,
,2021-08-02 04:00:00,10,6,4,Mäßiger bis starker Regenschauer,12,12,0.5,
,2021-08-02 05:00:00,44,20,24,Stellenweiser Regenfall,13,13,0.3,
,2021-08-02 06:00:00,149,97,52,Stellenweiser Regenfall,13,14,0.4,
,2021-08-02 07:00:00,381,217,164,Stellenweiser Regenfall,14,15,0.2,
,2021-08-02 08:00:00,592,326,266,Stellenweiser Regenfall,15,16,0.2,
,2021-08-02 09:00:00,511,298,213,Stellenweiser Regenfall,17,17,0.3,
,2021-08-02 10:00:00,562,331,231,Stellenweiser Regenfall,18,18,0.2,
,2021-08-02 11:00:00,645,341,304,Stellenweiser Regenfall,19,19,0.1,
,2021-08-02 12:00:00,732,378,354,Stellenweiser Regenfall,20,20,0.2,
,2021-08-02 13:00:00,753,362,391,Stellenweiser Regenfall,20,20,0.1,
,2021-08-02 14:00:00,764,395,369,Stellenweiser Regenfall,21,21,0.1,
,2021-08-02 15:00:00,918,460,458,Stellenweiser Regenfall,22,22,0.1,
,2021-08-02 16:00:00,1045,486,559,Stellenweiser Regenfall,21,21,0,
,2021-08-02 17:00:00,1144,519,625,Stellenweiser Regenfall,20,20,0,
,2021-08-02 18:00:00,921,434,487,Stellenweiser Regenfall,19,19,0,
,2021-08-02 19:00:00,662,309,353,Stellenweiser Regenfall,17,17,0,
,2021-08-02 20:00:00,558,263,295,Leicht bewölkt,16,16,0,
,2021-08-02 21:00:00,387,147,240,Leicht bewölkt,14,14,0,
,2021-08-02 22:00:00,242,71,171,Leicht bewölkt,13,13,0,
,2021-08-02 23:00:00,158,56,102,Stellenweiser Regenfall,12,12,0.2,
,2021-08-03 00:00:00,81,17,64,Stellenweiser Regenfall,11,11,0.3,
,2021-08-03 01:00:00,56,23,33,Stellenweiser Regenfall,11,11,0.2,
,2021-08-03 02:00:00,38,7,31,Stellenweiser Regenfall,11,11,0.1,
,2021-08-03 03:00:00,7,2,5,Stellenweiser Regenfall,11,11,0.1,
,2021-08-03 04:00:00,16,9,7,Stellenweiser Regenfall,11,12,0,
,2021-08-03 05:00:00,60,37,23,Leicht bewölkt,12,12,0,
,2021-08-03 06:00:00,188,110,78,Leicht bewölkt,13,13,0,
,2021-08-03 07:00:00,443,248,195,Leicht bewölkt,14,15,0,
,2021-08-03 08:00:00,694,398,296,Leicht bewölkt,16,16,0,
,2021-08-03 09:00:00,608,372,236,Leicht bewölkt,18,18,0,
,2021-08-03 10:00:00,620,349,271,Leicht bewölkt,19,19,0,
,2021-08-03 11:00:00,696,389,307,Leicht bewölkt,21,21,0,
,2021-08-03 12:00:00,731,343,388,Leicht bewölkt,22,22,0,
,2021-08-03 13:00:00,697,312,385,Leicht bewölkt,20,20,0,
,2021-08-03 14:00:00,834,396,438,Stellenweiser Regenfall,19,19,0.8,
,2021-08-03 15:00:00,670,287,383,Stellenweiser Regenfall,17,17,1.1,
,2021-08-03 16:00:00,806,382,424,Stellenweiser Regenfall,16,16,0.5,
,2021-08-03 17:00:00,845,400,445,Mäßiger Regenfall,15,15,0.4,
,2021-08-03 18:00:00,661,270,391,Mäßiger Regenfall,14,14,0.5,
,2021-08-03 19:00:00,530,239,291,Mäßiger Regenfall,14,14,0.3,
,2021-08-03 20:00:00,368,170,198,Leicht bewölkt,13,13,0,
,2021-08-03 21:00:00,253,128,125,Leicht bewölkt,13,13,0,
,2021-08-03 22:00:00,157,71,86,Leicht bewölkt,12,12,0,
,2021-08-03 23:00:00,120,32,88,Leichter Regenschauer,12,12,0.3,
,2021-08-04 00:00:00,65,16,49,Leichter Regenschauer,12,12,0.6,
,2021-08-04 01:00:00,40,13,27,Leichter Regenschauer,12,12,0.3,
,2021-08-04 02:00:00,25,13,12,Leichter Regenschauer,12,12,0.1,
,2021-08-04 03:00:00,8,0,8,Leichter Regenschauer,12,12,0.1,
,2021-08-04 04:00:00,18,7,11,Leichter Regenschauer,12,12,0.1,
,2021-08-04 05:00:00,49,27,22,Bewölkt,13,13,0,
,2021-08-04 06:00:00,138,81,57,Bewölkt,13,13,0,
,2021-08-04 07:00:00,402,224,178,Bewölkt,14,14,0,
,2021-08-04 08:00:00,607,332,275,Bedeckt,14,14,0,
,2021-08-04 09:00:00,526,354,172,Bedeckt,14,15,0,
,2021-08-04 10:00:00,481,264,217,Bedeckt,14,15,0,
,2021-08-04 11:00:00,540,275,265,Nieselregen,15,15,0,
,2021-08-04 12:00:00,629,308,321,Nieselregen,15,15,0,
,2021-08-04 13:00:00,570,297,273,Nieselregen,15,15,0,
,2021-08-04 14:00:00,534,270,264,Leichter Nebel,15,15,0.1,
,2021-08-04 15:00:00,581,232,349,Leichter Nebel,15,15,0.1,
,2021-08-04 16:00:00,611,284,327,Leichter Nebel,15,15,0,
,2021-08-04 17:00:00,596,254,342,Stellenweiser Nieselregen,15,15,0,
,2021-08-04 18:00:00,570,262,308,Stellenweiser Nieselregen,15,15,0,
,2021-08-04 19:00:00,411,201,210,Stellenweiser Nieselregen,14,14,0,
,2021-08-04 20:00:00,319,150,169,Leicht bewölkt,13,13,0,
,2021-08-04 21:00:00,176,67,109,Leicht bewölkt,12,12,0,
,2021-08-04 22:00:00,171,86,85,Leicht bewölkt,12,13,0,
,2021-08-04 23:00:00,113,36,77,Nieselregen,12,13,0.7,
,2021-08-05 00:00:00,76,37,39,Nieselregen,13,13,1.3,
,2021-08-05 01:00:00,45,16,29,Nieselregen,12,13,0.7,
,2021-08-05 02:00:00,33,18,15,Mäßiger Regenfall,12,13,1,
,2021-08-05 03:00:00,15,7,8,Mäßiger Regenfall,12,12,1.4,
,2021-08-05 04:00:00,15,9,6,Mäßiger Regenfall,13,13,0.7,
,2021-08-05 05:00:00,46,27,19,Mäßiger Regenfall,13,13,1.1,
,2021-08-05 06:00:00,146,81,65,Mäßiger Regenfall,13,13,1.5,
,2021-08-05 07:00:00,391,207,184,Mäßiger Regenfall,14,14,0.8,
,2021-08-05 08:00:00,539,307,232,Mäßiger Regenfall,14,14,0.5,
,2021-08-05 09:00:00,542,318,224,Mäßiger Regenfall,15,15,0.7,
,2021-08-05 10:00:00,471,278,193,Mäßiger Regenfall,16,16,0.4,
,2021-08-05 11:00:00,598,324,274,Leichter Regenschauer,17,17,0.1,
,2021-08-05 12:00:00,644,311,333,Leichter Regenschauer,18,18,0.1,
,2021-08-05 13:00:00,670,308,362,Leichter Regenschauer,18,18,0,
,2021-08-05 14:00:00,704,381,323,Leicht bewölkt,19,19,0.3,
,2021-08-05 15:00:00,733,316,417,Leicht bewölkt,19,19,0.4,
,2021-08-05 16:00:00,723,363,360,Leicht bewölkt,18,18,0.2,
,2021-08-05 17:00:00,803,373,430,Leichter Regenschauer,17,17,0.2,
,2021-08-05 18:00:00,754,354,400,Leichter Regenschauer,16,15,0.3,
,2021-08-05 19:00:00,545,254,291,Leichter Regenschauer,15,14,0.1,
,2021-08-05 20:00:00,431,179,252,Stellenweiser Regenfall,13,13,0.1,
,2021-08-05 21:00:00,274,110,164,Stellenweiser Regenfall,12,12,0.1,
,2021-08-05 22:00:00,216,81,135,Stellenweiser Regenfall,12,12,0,
,2021-08-05 23:00:00,160,53,107,Stellenweiser Regenfall,12,12,0.2,
,2021-08-06 00:00:00,107,43,64,Stellenweiser Regenfall,12,11,0.3,
,2021-08-06 01:00:00,53,22,31,Stellenweiser Regenfall,12,11,0.2,
,2021-08-06 02:00:00,30,11,19,Leicht bewölkt,11,11,0,
,2021-08-06 03:00:00,9,3,6,Leicht bewölkt,11,11,0,
,2021-08-06 04:00:00,16,14,2,Leicht bewölkt,12,12,0,
,2021-08-06 05:00:00,42,23,19,Leicht bewölkt,12,13,0,
,2021-08-06 06:00:00,139,86,53,Leicht bewölkt,13,14,0,
,2021-08-06 07:00:00,285,160,125,Leicht bewölkt,15,15,0,
,2021-08-06 08:00:00,492,307,185,Stellenweiser Regenfall,16,17,0,
,2021-08-06 09:00:00,529,312,217,Stellenweiser Regenfall,18,18,0,
,2021-08-06 10:00:00,537,312,225,Stellenweiser Regenfall,19,19,0,
,2021-08-06 11:00:00,594,292,302,Stellenweiser Regenfall,20,20,0,
,2021-08-06 12:00:00,671,312,359,Stellenweiser Regenfall,21,21,0,
,2021-08-06 13:00:00,698,316,382,Stellenweiser Regenfall,21,21,0,
,2021-08-06 14:00:00,704,358,346,Leicht bewölkt,21,21,0,
,2021-08-06 15:00:00,816,419,397,Leicht bewölkt,21,21,0,
,2021-08-06 16:00:00,767,358,409,Leicht bewölkt,20,20,0,
,2021-08-06 17:00:00,811,407,404,Stellenweiser Regenfall,20,20,0,
,2021-08-06 18:00:00,747,355,392,Stellenweiser Regenfall,19,19,0,
,2021-08-06 19:00:00,704,338,366,Stellenweiser Regenfall,18,18,0,
,2021-08-06 20:00:00,467,238,229,Bewölkt,17,17,0,
,2021-08-06 21:00:00,392,178,214,Bewölkt,15,15,0,
,2021-08-06 22:00:00,277,116,161,Bewölkt,15,15,0,
,2021-08-06 23:00:00,239,80,159,Leicht bewölkt,14,14,0,
,2021-08-07 00:00:00,216,78,138,Leicht bewölkt,13,13,0,
,2021-08-07 01:00:00,126,46,80,Leicht bewölkt,13,13,0,
,2021-08-07 02:00:00,121,49,72,Leicht bewölkt,12,13,0,
,2021-08-07 03:00:00,85,30,55,Leicht bewölkt,12,12,0,
,2021-08-07 04:00:00,51,17,34,Leicht bewölkt,13,13,0,
,2021-08-07 05:00:00,46,22,24,Bedeckt,14,14,0,
,2021-08-07 06:00:00,61,38,23,Bedeckt,15,15,0,
,2021-08-07 07:00:00,83,40,43,Bedeckt,17,17,0,
,2021-08-07 08:00:00,209,118,91,Leicht bewölkt,18,18,0,
,2021-08-07 09:00:00,382,228,154,Leicht bewölkt,20,20,0,
,2021-08-07 10:00:00,473,235,238,Leicht bewölkt,22,22,0,
,2021-08-07 11:00:00,602,314,288,Leicht bewölkt,23,25,0,
,2021-08-07 12:00:00,577,313,264,Leicht bewölkt,25,26,0,
,2021-08-07 13:00:00,508,235,273,Leicht bewölkt,24,25,0,
,2021-08-07 14:00:00,537,252,285,Leicht bewölkt,23,24,0.2,
,2021-08-07 15:00:00,297,130,167,Leicht bewölkt,23,23,0.2,
,2021-08-07 16:00:00,284,131,153,Leicht bewölkt,21,21,0.1,
,2021-08-07 17:00:00,217,95,122,Leichter Regenschauer,20,20,1.2,
,2021-08-07 18:00:00,195,71,124,Leichter Regenschauer,19,19,1.6,
,2021-08-07 19:00:00,200,102,98,Leichter Regenschauer,18,18,0.8,
,2021-08-07 20:00:00,148,71,77,Mäßiger Regenfall,16,16,1.3,
,2021-08-07 21:00:00,173,89,84,Mäßiger Regenfall,15,15,1.7,
,2021-08-07 22:00:00,108,56,52,Mäßiger Regenfall,15,15,0.9,
,2021-08-07 23:00:00,110,41,69,Teilweise mäßiger Regenfall,15,14,0.5,
,2021-08-08 00:00:00,98,32,66,Teilweise mäßiger Regenfall,15,14,1.1,
,2021-08-08 01:00:00,65,19,46,Teilweise mäßiger Regenfall,14,13,0.5,
,2021-08-08 02:00:00,64,21,43,Leichter Nebel,13,12,0,
,2021-08-08 03:00:00,66,20,46,Leichter Nebel,12,12,0,
,2021-08-08 04:00:00,27,4,23,Leichter Nebel,12,12,0,
,2021-08-08 05:00:00,25,9,16,Stellenweiser Regenfall,13,12,0,
,2021-08-08 06:00:00,48,25,23,Stellenweiser Regenfall,13,12,0,
,2021-08-08 07:00:00,40,25,15,Stellenweiser Regenfall,13,13,0,
,2021-08-08 08:00:00,72,34,38,Bedeckt,13,13,0.1,
,2021-08-08 09:00:00,205,94,111,Bedeckt,13,13,0.2,
,2021-08-08 10:00:00,303,156,147,Bedeckt,13,13,0.1,
,2021-08-08 11:00:00,372,209,163,Nieselregen,13,13,0.5,
,2021-08-08 12:00:00,380,192,188,Nieselregen,13,13,0.7,
,2021-08-08 13:00:00,457,203,254,Nieselregen,14,14,0.3,
,2021-08-08 14:00:00,438,202,236,Stellenweiser leichter Regenfall,14,14,0.4,
,2021-08-08 15:00:00,428,222,206,Stellenweiser leichter Regenfall,15,15,0.6,
,2021-08-08 16:00:00,431,209,222,Stellenweiser leichter Regenfall,15,15,0.3,
,2021-08-08 17:00:00,475,252,223,Leichter Regenschauer,15,15,0.1,
,2021-08-08 18:00:00,484,269,215,Leichter Regenschauer,15,15,0.1,
,2021-08-08 19:00:00,391,166,225,Leichter Regenschauer,14,14,0.1,
,2021-08-08 20:00:00,331,148,183,Leicht bewölkt,13,13,0,
,2021-08-08 21:00:00,191,55,136,Leicht bewölkt,12,12,0,
,2021-08-08 22:00:00,159,57,102,Leicht bewölkt,12,12,0,
,2021-08-08 23:00:00,87,42,45,Leicht bewölkt,11,11,0,
,2021-08-09 00:00:00,60,14,46,Leicht bewölkt,11,11,0,
,2021-08-09 01:00:00,23,13,10,Leicht bewölkt,11,11,0,
,2021-08-09 02:00:00,21,8,13,Leicht bewölkt,11,11,0,
,2021-08-09 03:00:00,4,4,0,Leicht bewölkt,10,10,0,
,2021-08-09 04:00:00,10,6,4,Leicht bewölkt,11,11,0,
,2021-08-09 05:00:00,49,27,22,Leicht bewölkt,12,12,0,
,2021-08-09 06:00:00,165,104,61,Leicht bewölkt,12,12,0,
,2021-08-09 07:00:00,338,192,146,Leicht bewölkt,14,14,0,
,2021-08-09 08:00:00,545,335,210,Leicht bewölkt,16,16,0,
,2021-08-09 09:00:00,493,293,200,Leicht bewölkt,18,18,0,
,2021-08-09 10:00:00,593,338,255,Leicht bewölkt,19,19,0,
,2021-08-09 11:00:00,701,350,351,Leicht bewölkt,21,21,0,
,2021-08-09 12:00:00,728,355,373,Leicht bewölkt,22,23,0,
,2021-08-09 13:00:00,691,352,339,Leicht bewölkt,23,24,0,
,2021-08-09 14:00:00,791,396,395,Leicht bewölkt,23,24,0,
,2021-08-09 15:00:00,821,399,422,Leicht bewölkt,24,25,0,
,2021-08-09 16:00:00,1008,442,566,Leicht bewölkt,23,25,0,
,2021-08-09 17:00:00,957,439,518,Leicht bewölkt,23,25,0,
,2021-08-09 18:00:00,792,338,454,Leicht bewölkt,22,25,0,
,2021-08-09 19:00:00,607,283,324,Leicht bewölkt,21,21,0,
,2021-08-09 20:00:00,419,188,231,Leicht bewölkt,20,20,0,
,2021-08-09 21:00:00,291,123,168,Leicht bewölkt,19,19,0,
,2021-08-09 22:00:00,183,74,109,Leicht bewölkt,17,17,0,
,2021-08-09 23:00:00,117,56,61,Leicht bewölkt,16,16,0,
,2021-08-10 00:00:00,58,25,33,Leicht bewölkt,15,15,0,
,2021-08-10 01:00:00,37,10,27,Leicht bewölkt,14,14,0,
,2021-08-10 02:00:00,14,6,8,Leicht bewölkt,13,13,0,
,2021-08-10 03:00:00,14,5,9,Leicht bewölkt,12,12,0,
,2021-08-10 04:00:00,19,17,2,Leicht bewölkt,12,12,0,
,2021-08-10 05:00:00,48,26,22,Leicht bewölkt,13,13,0,
,2021-08-10 06:00:00,180,109,71,Leicht bewölkt,14,14,0,
,2021-08-10 07:00:00,410,231,179,Leicht bewölkt,16,16,0,
,2021-08-10 08:00:00,606,358,248,Stellenweiser Regenfall,17,17,0,
,2021-08-10 09:00:00,551,318,233,Stellenweiser Regenfall,19,19,0,
,2021-08-10 10:00:00,672,376,296,Stellenweiser Regenfall,20,20,0,
,2021-08-10 11:00:00,728,375,353,Stellenweiser Regenfall,22,22,0,
,2021-08-10 12:00:00,771,368,403,Stellenweiser Regenfall,23,24,0,
,2021-08-10 13:00:00,675,332,343,Stellenweiser Regenfall,24,25,0,
,2021-08-10 14:00:00,803,384,419,Stellenweiser Regenfall,25,25,0,
,2021-08-10 15:00:00,859,446,413,Stellenweiser Regenfall,25,26,0,
,2021-08-10 16:00:00,927,455,472,Stellenweiser Regenfall,25,26,0,
,2021-08-10 17:00:00,1069,529,540,Leicht bewölkt,25,27,0,
,2021-08-10 18:00:00,986,452,534,Leicht bewölkt,24,27,0,
,2021-08-10 19:00:00,797,382,415,Leicht bewölkt,23,26,0,
,2021-08-10 20:00:00,562,252,310,Leicht bewölkt,22,26,0.2,
,2021-08-10 21:00:00,363,175,188,Leicht bewölkt,22,22,0.3,
,2021-08-10 22:00:00,251,70,181,Leicht bewölkt,20,20,0.2,
,2021-08-10 23:00:00,137,49,88,Leicht bewölkt,18,18,0,
,2021-08-11 00:00:00,79,18,61,Leicht bewölkt,16,16,0,
,2021-08-11 01:00:00,51,18,33,Leicht bewölkt,15,15,0,
,2021-08-11 02:00:00,19,7,12,Leicht bewölkt,15,15,0,
,2021-08-11 03:00:00,15,2,13,Leicht bewölkt,14,14,0,
,2021-08-11 04:00:00,12,9,3,Leicht bewölkt,15,15,0,
,2021-08-11 05:00:00,51,28,23,Stellenweiser Regenfall,15,15,0.1,
,2021-08-11 06:00:00,163,99,64,Stellenweiser Regenfall,16,16,0.1,
,2021-08-11 07:00:00,392,214,178,Stellenweiser Regenfall,17,17,0,
,2021-08-11 08:00:00,604,361,243,Stellenweiser Regenfall,19,19,0,
,2021-08-11 09:00:00,602,345,257,Stellenweiser Regenfall,21,21,0,
,2021-08-11 10:00:00,659,378,281,Stellenweiser Regenfall,22,24,0,
,2021-08-11 11:00:00,740,379,361,Leicht bewölkt,23,25,0,
,2021-08-11 12:00:00,760,332,428,Leicht bewölkt,25,26,0,
,2021-08-11 13:00:00,731,341,390,Leicht bewölkt,25,27,0,
,2021-08-11 14:00:00,853,421,432,Leicht bewölkt,26,27,0,
,2021-08-11 15:00:00,835,418,417,Leicht bewölkt,26,27,0,
,2021-08-11 16:00:00,891,476,415,Leicht bewölkt,26,27,0,
,2021-08-11 17:00:00,1080,537,543,Stellenweiser Regenfall,25,27,0.1,
,2021-08-11 18:00:00,1044,493,551,Stellenweiser Regenfall,25,27,0.1,
,2021-08-11 19:00:00,753,344,409,Stellenweiser Regenfall,24,26,0.1,
,2021-08-11 20:00:00,686,296,390,Stellenweiser Regenfall,22,25,0,
,2021-08-11 21:00:00,439,175,264,Stellenweiser Regenfall,21,21,0,
,2021-08-11 22:00:00,320,116,204,Stellenweiser Regenfall,20,20,0,
,2021-08-11 23:00:00,179,59,120,Leicht bewölkt,19,19,0,
,2021-08-12 00:00:00,131,50,81,Leicht bewölkt,18,18,0,
,2021-08-12 01:00:00,84,26,58,Leicht bewölkt,17,17,0,
,2021-08-12 02:00:00,48,17,31,Leicht bewölkt,16,16,0,
,2021-08-12 03:00:00,21,8,13,Leicht bewölkt,15,15,0,
,2021-08-12 04:00:00,14,11,3,Leicht bewölkt,16,16,0,
,2021-08-12 05:00:00,44,29,15,Leicht bewölkt,16,16,0,
,2021-08-12 06:00:00,166,101,65,Leicht bewölkt,17,17,0,
,2021-08-12 07:00:00,388,206,182,Leicht bewölkt,19,19,0,
,2021-08-12 08:00:00,571,348,223,Leicht bewölkt,20,20,0,
,2021-08-12 09:00:00,590,320,270,Leicht bewölkt,22,23,0,
,2021-08-12 10:00:00,586,320,266,Leicht bewölkt,24,25,0,
,2021-08-12 11:00:00,679,371,308,Leicht bewölkt,25,26,0,
,2021-08-12 12:00:00,756,333,423,Leicht bewölkt,27,28,0,
,2021-08-12 13:00:00,746,340,406,Leicht bewölkt,28,29,0,
,2021-08-12 14:00:00,721,337,384,Leicht bewölkt,29,30,0,
,2021-08-12 15:00:00,748,367,381,Leicht bewölkt,29,31,0,
,2021-08-12 16:00:00,860,439,421,Leicht bewölkt,29,31,0,
,2021-08-12 17:00:00,932,453,479,Leicht bewölkt,29,31,0,
,2021-08-12 18:00:00,969,473,496,Leicht bewölkt,29,30,0,
,2021-08-12 19:00:00,767,377,390,Leicht bewölkt,28,30,0,
,2021-08-12 20:00:00,627,263,364,Leicht bewölkt,27,29,0,
,2021-08-12 21:00:00,494,189,305,Leicht bewölkt,26,29,0,
,2021-08-12 22:00:00,331,113,218,Leicht bewölkt,24,26,0,
,2021-08-12 23:00:00,198,80,118,Leicht bewölkt,22,22,0,
,2021-08-13 00:00:00,105,35,70,Leicht bewölkt,20,20,0.1,
,2021-08-13 01:00:00,88,28,60,Leicht bewölkt,19,19,0,
,2021-08-13 02:00:00,44,21,23,Stellenweiser Regenfall,18,18,0.8,
,2021-08-13 03:00:00,25,9,16,Stellenweiser Regenfall,17,17,1.1,
,2021-08-13 04:00:00,13,10,3,Stellenweiser Regenfall,17,17,0.6,
,2021-08-13 05:00:00,43,21,22,Mäßiger bis starker Regenschauer,17,17,2.5,
,2021-08-13 06:00:00,140,86,54,Mäßiger bis starker Regenschauer,18,18,3.4,
,2021-08-13 07:00:00,363,204,159,Mäßiger bis starker Regenschauer,19,19,1.7,
,2021-08-13 08:00:00,527,328,199,Sintflutartiger Regenfall,21,21,1.1,
,2021-08-13 09:00:00,582,363,219,Sintflutartiger Regenfall,22,24,1.5,
,2021-08-13 10:00:00,670,397,273,Sintflutartiger Regenfall,24,25,0.7,
,2021-08-13 11:00:00,749,379,370,Stellenweiser Regenfall,26,27,0,
,2021-08-13 12:00:00,799,350,449,Stellenweiser Regenfall,27,29,0,
,2021-08-13 13:00:00,692,327,365,Stellenweiser Regenfall,28,29,0,
,2021-08-13 14:00:00,844,439,405,Leicht bewölkt,28,30,0,
,2021-08-13 15:00:00,736,345,391,Leicht bewölkt,29,31,0,
,2021-08-13 16:00:00,784,402,382,Leicht bewölkt,29,31,0,
,2021-08-13 17:00:00,792,382,410,Leicht bewölkt,28,31,0,
,2021-08-13 18:00:00,816,385,431,Leicht bewölkt,28,31,0,
,2021-08-13 19:00:00,680,349,331,Leicht bewölkt,27,30,0,
,2021-08-13 20:00:00,585,276,309,Leicht bewölkt,26,29,0.4,
,2021-08-13 21:00:00,411,168,243,Leicht bewölkt,25,28,0.5,
,2021-08-13 22:00:00,294,120,174,Leicht bewölkt,23,25,0.3,
,2021-08-13 23:00:00,232,82,150,Stellenweiser Regenfall,21,21,0.3,
,2021-08-14 00:00:00,164,60,104,Stellenweiser Regenfall,20,20,0.7,
,2021-08-14 01:00:00,123,47,76,Stellenweiser Regenfall,19,19,0.3,
,2021-08-14 02:00:00,85,27,58,Stellenweiser Regenfall,18,18,0.1,
,2021-08-14 03:00:00,76,17,59,Stellenweiser Regenfall,17,17,0.2,
,2021-08-14 04:00:00,26,10,16,Stellenweiser Regenfall,18,18,0.1,
,2021-08-14 05:00:00,50,26,24,Leichter Nebel,18,18,0,
,2021-08-14 06:00:00,66,38,28,Leichter Nebel,19,19,0,
,2021-08-14 07:00:00,100,41,59,Leichter Nebel,20,20,0,
,2021-08-14 08:00:00,258,139,119,Leicht bewölkt,21,21,0,
,2021-08-14 09:00:00,460,288,172,Leicht bewölkt,23,24,0,
,2021-08-14 10:00:00,607,342,265,Leicht bewölkt,24,26,0,
,2021-08-14 11:00:00,714,330,384,Leicht bewölkt,26,27,0,
,2021-08-14 12:00:00,652,274,378,Leicht bewölkt,27,29,0,
,2021-08-14 13:00:00,585,304,281,Leicht bewölkt,28,30,0,
,2021-08-14 14:00:00,683,312,371,Leicht bewölkt,28,30,0,
,2021-08-14 15:00:00,658,302,356,Leicht bewölkt,29,31,0,
,2021-08-14 16:00:00,518,232,286,Leicht bewölkt,28,30,0,
,2021-08-14 17:00:00,655,336,319,Leicht bewölkt,27,30,0.1,
,2021-08-14 18:00:00,658,320,338,Leicht bewölkt,27,30,0.2,
,2021-08-14 19:00:00,598,322,276,Leicht bewölkt,25,29,0.1,
,2021-08-14 20:00:00,570,304,266,Teilweise mäßiger Regenfall,24,28,0.1,
,2021-08-14 21:00:00,472,229,243,Teilweise mäßiger Regenfall,23,27,0.1,
,2021-08-14 22:00:00,262,118,144,Teilweise mäßiger Regenfall,22,22,0.1,
,2021-08-14 23:00:00,243,98,145,Leicht bewölkt,21,21,0.1,
,2021-08-15 00:00:00,166,52,114,Leicht bewölkt,19,19,0.2,
,2021-08-15 01:00:00,133,44,89,Leicht bewölkt,19,19,0.1,
,2021-08-15 02:00:00,94,26,68,Stellenweiser Regenfall,18,18,0,
,2021-08-15 03:00:00,64,16,48,Stellenweiser Regenfall,17,17,0,
,2021-08-15 04:00:00,44,11,33,Stellenweiser Regenfall,18,18,0,
,2021-08-15 05:00:00,26,9,17,Leicht bewölkt,18,18,0,
,2021-08-15 06:00:00,50,28,22,Leicht bewölkt,19,19,0,
,2021-08-15 07:00:00,80,44,36,Leicht bewölkt,20,20,0,
,2021-08-15 08:00:00,143,62,81,Leicht bewölkt,21,21,0,
,2021-08-15 09:00:00,313,180,133,Leicht bewölkt,23,24,0,
,2021-08-15 10:00:00,385,187,198,Leicht bewölkt,24,26,0,
,2021-08-15 11:00:00,444,193,251,Leicht bewölkt,26,27,0,
,2021-08-15 12:00:00,493,231,262,Leicht bewölkt,27,29,0,
,2021-08-15 13:00:00,565,286,279,Leicht bewölkt,28,30,0,
,2021-08-15 14:00:00,482,275,207,Leicht bewölkt,28,30,0,
,2021-08-15 15:00:00,395,188,207,Leicht bewölkt,29,31,0,
,2021-08-15 16:00:00,485,247,238,Leicht bewölkt,28,31,0,
,2021-08-15 17:00:00,528,262,266,Leicht bewölkt,28,30,0.1,
,2021-08-15 18:00:00,523,247,276,Leicht bewölkt,27,30,0.1,
,2021-08-15 19:00:00,422,199,223,Leicht bewölkt,26,29,0,
,2021-08-15 20:00:00,367,169,198,Nieselregen mit Gewitter,25,28,0.5,
,2021-08-15 21:00:00,258,104,154,Nieselregen mit Gewitter,24,27,0.7,
,2021-08-15 22:00:00,154,62,92,Nieselregen mit Gewitter,22,25,0.4,
,2021-08-15 23:00:00,95,43,52,Mäßiger bis starker Regenschauer,20,20,0.4,
,2021-08-16 00:00:00,60,24,36,Mäßiger bis starker Regenschauer,18,18,0.7,
,2021-08-16 01:00:00,25,11,14,Mäßiger bis starker Regenschauer,17,17,0.4,
,2021-08-16 02:00:00,16,8,8,Leicht bewölkt,16,16,0,
,2021-08-16 03:00:00,13,5,8,Leicht bewölkt,16,16,0,
,2021-08-16 04:00:00,7,4,3,Leicht bewölkt,16,16,0,
,2021-08-16 05:00:00,32,20,12,Leicht bewölkt,16,16,0,
,2021-08-16 06:00:00,145,90,55,Leicht bewölkt,17,17,0,
,2021-08-16 07:00:00,316,184,132,Leicht bewölkt,17,17,0,
,2021-08-16 08:00:00,399,221,178,Stellenweiser Regenfall,18,18,0.1,
,2021-08-16 09:00:00,458,279,179,Stellenweiser Regenfall,19,19,0.1,
,2021-08-16 10:00:00,485,263,222,Stellenweiser Regenfall,20,20,0.1,
,2021-08-16 11:00:00,431,205,226,Stellenweiser Regenfall,21,21,0.1,
,2021-08-16 12:00:00,364,150,214,Stellenweiser Regenfall,21,21,0.1,
,2021-08-16 13:00:00,388,189,199,Stellenweiser Regenfall,21,21,0.1,
,2021-08-16 14:00:00,420,234,186,Stellenweiser Regenfall,22,22,0,
,2021-08-16 15:00:00,483,240,243,Stellenweiser Regenfall,22,22,0,
,2021-08-16 16:00:00,599,304,295,Stellenweiser Regenfall,21,21,0,
,2021-08-16 17:00:00,715,337,378,Leicht bewölkt,19,19,0,
,2021-08-16 18:00:00,647,311,336,Leicht bewölkt,18,18,0,
,2021-08-16 19:00:00,455,223,232,Leicht bewölkt,17,17,0,
,2021-08-16 20:00:00,364,171,193,Leicht bewölkt,16,16,0,
,2021-08-16 21:00:00,202,83,119,Leicht bewölkt,15,15,0,
,2021-08-16 22:00:00,160,70,90,Leicht bewölkt,15,14,0,
,2021-08-16 23:00:00,100,30,70,Stellenweiser Nieselregen,14,14,0.1,
,2021-08-17 00:00:00,66,19,47,Stellenweiser Nieselregen,14,13,0.1,
,2021-08-17 01:00:00,38,12,26,Stellenweiser Nieselregen,13,13,0.1,
,2021-08-17 02:00:00,19,11,8,Stellenweiser Regenfall,13,12,0,
,2021-08-17 03:00:00,15,10,5,Stellenweiser Regenfall,12,12,0,
,2021-08-17 04:00:00,8,5,3,Stellenweiser Regenfall,13,12,0,
,2021-08-17 05:00:00,37,17,20,Leicht bewölkt,13,13,0,
,2021-08-17 06:00:00,161,105,56,Leicht bewölkt,13,13,0,
,2021-08-17 07:00:00,355,202,153,Leicht bewölkt,14,14,0,
,2021-08-17 08:00:00,463,284,179,Leicht bewölkt,14,14,0,
,2021-08-17 09:00:00,535,346,189,Leicht bewölkt,15,15,0,
,2021-08-17 10:00:00,588,353,235,Leicht bewölkt,16,16,0,
,2021-08-17 11:00:00,680,374,306,Bewölkt,17,17,0,
,2021-08-17 12:00:00,752,353,399,Bewölkt,18,18,0,
,2021-08-17 13:00:00,740,385,355,Bewölkt,18,18,0,
,2021-08-17 14:00:00,698,344,354,Leicht bewölkt,18,18,0.2,
,2021-08-17 15:00:00,794,403,391,Leicht bewölkt,19,19,0.2,
,2021-08-17 16:00:00,858,441,417,Leicht bewölkt,18,18,0.1,
,2021-08-17 17:00:00,952,426,526,Stellenweiser Regenfall,17,17,0.2,
,2021-08-17 18:00:00,886,386,500,Stellenweiser Regenfall,16,16,0.3,
,2021-08-17 19:00:00,644,287,357,Stellenweiser Regenfall,15,15,0.1,
,2021-08-17 20:00:00,407,197,210,Stellenweiser Regenfall,14,15,0.1,
,2021-08-17 21:00:00,309,124,185,Stellenweiser Regenfall,14,14,0.1,
,2021-08-17 22:00:00,237,78,159,Stellenweiser Regenfall,14,14,0,
,2021-08-17 23:00:00,157,36,121,Bedeckt,14,14,0,
,2021-08-18 00:00:00,64,20,44,Bedeckt,14,14,0,
,2021-08-18 01:00:00,61,20,41,Bedeckt,13,14,0,
,2021-08-18 02:00:00,14,4,10,Bewölkt,13,14,0,
,2021-08-18 03:00:00,22,11,11,Bewölkt,13,14,0,
,2021-08-18 04:00:00,12,7,5,Bewölkt,14,14,0,
,2021-08-18 05:00:00,55,32,23,Leicht bewölkt,14,14,0,
,2021-08-18 06:00:00,142,99,43,Leicht bewölkt,14,14,0,
,2021-08-18 07:00:00,290,162,128,Leicht bewölkt,15,15,0,
,2021-08-18 08:00:00,471,282,189,Bewölkt,16,16,0,
,2021-08-18 09:00:00,516,304,212,Bewölkt,16,17,0,
,2021-08-18 10:00:00,488,273,215,Bewölkt,17,18,0,
,2021-08-18 11:00:00,584,307,277,Leicht bewölkt,18,18,0,
,2021-08-18 12:00:00,642,309,333,Leicht bewölkt,19,19,0,
,2021-08-18 13:00:00,667,362,305,Leicht bewölkt,19,19,0,
,2021-08-18 14:00:00,731,364,367,Leicht bewölkt,20,20,0,
,2021-08-18 15:00:00,756,368,388,Leicht bewölkt,20,20,0,
,2021-08-18 16:00:00,840,403,437,Leicht bewölkt,19,19,0,
,2021-08-18 17:00:00,891,408,483,Stellenweiser Regenfall,18,18,0,
,2021-08-18 18:00:00,874,373,501,Stellenweiser Regenfall,18,18,0,
,2021-08-18 19:00:00,676,303,373,Stellenweiser Regenfall,17,17,0,
,2021-08-18 20:00:00,426,190,236,Leicht bewölkt,15,15,0,
,2021-08-18 21:00:00,338,140,198,Leicht bewölkt,14,14,0,
,2021-08-18 22:00:00,237,84,153,Leicht bewölkt,14,14,0,
,2021-08-18 23:00:00,173,66,107,Leicht bewölkt,14,14,0,
,2021-08-19 00:00:00,93,26,67,Leicht bewölkt,13,14,0,
,2021-08-19 01:00:00,65,22,43,Leicht bewölkt,13,13,0,
,2021-08-19 02:00:00,20,9,11,Leicht bewölkt,13,13,0,
,2021-08-19 03:00:00,18,7,11,Leicht bewölkt,12,12,0,
,2021-08-19 04:00:00,8,4,4,Leicht bewölkt,12,13,0,
,2021-08-19 05:00:00,59,36,23,Leicht bewölkt,13,13,0,
,2021-08-19 06:00:00,165,104,61,Leicht bewölkt,13,13,0,
,2021-08-19 07:00:00,320,180,140,Leicht bewölkt,15,15,0,
,2021-08-19 08:00:00,452,277,175,Leicht bewölkt,16,16,0,
,2021-08-19 09:00:00,452,268,184,Leicht bewölkt,17,17,0,
,2021-08-19 10:00:00,598,363,235,Leicht bewölkt,19,19,0,
,2021-08-19 11:00:00,621,348,273,Leicht bewölkt,20,20,0,
,2021-08-19 12:00:00,649,333,316,Leicht bewölkt,21,21,0,
,2021-08-19 13:00:00,642,325,317,Leicht bewölkt,21,21,0,
,2021-08-19 14:00:00,808,410,398,Bewölkt,22,22,0,
,2021-08-19 15:00:00,845,414,431,Bewölkt,22,22,0,
,2021-08-19 16:00:00,867,421,446,Bewölkt,21,21,0,
,2021-08-19 17:00:00,971,495,476,Leicht bewölkt,20,20,0,
,2021-08-19 18:00:00,782,349,433,Leicht bewölkt,19,19,0,
,2021-08-19 19:00:00,611,273,338,Leicht bewölkt,17,17,0,
,2021-08-19 20:00:00,454,183,271,Stellenweiser Regenfall,16,16,0,
,2021-08-19 21:00:00,295,143,152,Stellenweiser Regenfall,15,15,0,
,2021-08-19 22:00:00,273,102,171,Stellenweiser Regenfall,14,14,0,
,2021-08-19 23:00:00,188,71,117,Leicht bewölkt,14,14,0,
,2021-08-20 00:00:00,123,39,84,Leicht bewölkt,14,14,0,
,2021-08-20 01:00:00,71,22,49,Leicht bewölkt,13,13,0,
,2021-08-20 02:00:00,32,10,22,Leicht bewölkt,13,13,0,
,2021-08-20 03:00:00,22,11,11,Leicht bewölkt,13,13,0,
,2021-08-20 04:00:00,16,12,4,Leicht bewölkt,13,13,0,
,2021-08-20 05:00:00,52,31,21,Leicht bewölkt,14,14,0,
,2021-08-20 06:00:00,145,97,48,Leicht bewölkt,14,14,0,
,2021-08-20 07:00:00,289,171,118,Leicht bewölkt,16,16,0,
,2021-08-20 08:00:00,424,259,165,Leicht bewölkt,17,17,0,
,2021-08-20 09:00:00,547,340,207,Leicht bewölkt,19,19,0,
,2021-08-20 10:00:00,703,418,285,Leicht bewölkt,20,20,0,
,2021-08-20 11:00:00,784,405,379,Leicht bewölkt,21,21,0,
,2021-08-20 12:00:00,744,375,369,Leicht bewölkt,23,24,0,
,2021-08-20 13:00:00,727,358,369,Leicht bewölkt,23,24,0,
,2021-08-20 14:00:00,844,418,426,Leicht bewölkt,24,25,0,
,2021-08-20 15:00:00,718,350,368,Leicht bewölkt,24,26,0,
,2021-08-20 16:00:00,767,350,417,Leicht bewölkt,24,25,0,
,2021-08-20 17:00:00,868,405,463,Leicht bewölkt,24,25,0,
,2021-08-20 18:00:00,793,376,417,Leicht bewölkt,23,25,0,
,2021-08-20 19:00:00,661,323,338,Leicht bewölkt,22,24,0,
,2021-08-20 20:00:00,506,241,265,Leicht bewölkt,21,21,0,
,2021-08-20 21:00:00,381,160,221,Leicht bewölkt,20,20,0,
,2021-08-20 22:00:00,253,99,154,Leicht bewölkt,19,19,0,
,2021-08-20 23:00:00,224,89,135,Leicht bewölkt,17,17,0,
,2021-08-21 00:00:00,181,67,114,Leicht bewölkt,16,16,0,
,2021-08-21 01:00:00,113,35,78,Leicht bewölkt,15,15,0,
,2021-08-21 02:00:00,78,30,48,Leicht bewölkt,14,14,0,
,2021-08-21 03:00:00,61,15,46,Leicht bewölkt,13,13,0,
,2021-08-21 04:00:00,41,18,23,Leicht bewölkt,14,14,0,
,2021-08-21 05:00:00,36,22,14,Leicht bewölkt,14,14,0,
,2021-08-21 06:00:00,68,49,19,Leicht bewölkt,15,15,0,
,2021-08-21 07:00:00,87,45,42,Leicht bewölkt,16,16,0,
,2021-08-21 08:00:00,259,157,102,Leicht bewölkt,18,18,0,
,2021-08-21 09:00:00,452,253,199,Leicht bewölkt,20,20,0,
,2021-08-21 10:00:00,646,348,298,Leicht bewölkt,22,22,0,
,2021-08-21 11:00:00,692,371,321,Leicht bewölkt,23,25,0,
,2021-08-21 12:00:00,709,376,333,Leicht bewölkt,25,26,0,
,2021-08-21 13:00:00,687,331,356,Leicht bewölkt,26,27,0,
,2021-08-21 14:00:00,792,382,410,Leicht bewölkt,26,27,0,
,2021-08-21 15:00:00,773,364,409,Leicht bewölkt,27,28,0,
,2021-08-21 16:00:00,685,322,363,Leicht bewölkt,26,27,0,
,2021-08-21 17:00:00,722,342,380,Leicht bewölkt,25,27,0,
,2021-08-21 18:00:00,730,358,372,Leicht bewölkt,25,26,0,
,2021-08-21 19:00:00,598,275,323,Leicht bewölkt,23,25,0,
,2021-08-21 20:00:00,501,266,235,Leicht bewölkt,22,24,0,
,2021-08-21 21:00:00,363,183,180,Leicht bewölkt,21,21,0,
,2021-08-21 22:00:00,268,128,140,Leicht bewölkt,19,19,0,
,2021-08-21 23:00:00,197,78,119,Leicht bewölkt,18,18,0,
,2021-08-22 00:00:00,189,49,140,Leicht bewölkt,17,17,0,
,2021-08-22 01:00:00,121,24,97,Leicht bewölkt,16,16,0,
,2021-08-22 02:00:00,103,32,71,Leicht bewölkt,16,16,0,
,2021-08-22 03:00:00,66,26,40,Leicht bewölkt,15,15,0,
,2021-08-22 04:00:00,35,11,24,Leicht bewölkt,16,16,0,
,2021-08-22 05:00:00,48,14,34,Leicht bewölkt,16,16,0,
,2021-08-22 06:00:00,31,16,15,Leicht bewölkt,17,17,0,
,2021-08-22 07:00:00,49,17,32,Leicht bewölkt,18,18,0,
,2021-08-22 08:00:00,95,62,33,Leicht bewölkt,19,19,0,
,2021-08-22 09:00:00,149,81,68,Leicht bewölkt,21,21,0,
,2021-08-22 10:00:00,256,134,122,Leicht bewölkt,22,22,0,
,2021-08-22 11:00:00,290,166,124,Stellenweiser Regenfall,22,24,0,
,2021-08-22 12:00:00,331,151,180,Stellenweiser Regenfall,23,25,0,
,2021-08-22 13:00:00,176,92,84,Stellenweiser Regenfall,23,24,0,
,2021-08-22 14:00:00,230,116,114,Leicht bewölkt,22,23,0.1,
,2021-08-22 15:00:00,213,111,102,Leicht bewölkt,22,22,0.1,
,2021-08-22 16:00:00,256,123,133,Leicht bewölkt,21,21,0.1,
,2021-08-22 17:00:00,275,139,136,Stellenweiser Regenfall,20,20,0.2,
,2021-08-22 18:00:00,223,111,112,Stellenweiser Regenfall,19,19,0.2,
,2021-08-22 19:00:00,212,101,111,Stellenweiser Regenfall,18,18,0.1,
,2021-08-22 20:00:00,173,72,101,Leichter Regenschauer,17,17,0.7,
,2021-08-22 21:00:00,123,54,69,Leichter Regenschauer,16,16,1,
,2021-08-22 22:00:00,78,30,48,Leichter Regenschauer,15,15,0.5,
,2021-08-22 23:00:00,43,19,24,Mäßiger bis starker Regenschauer,15,15,1.1,
,2021-08-23 00:00:00,38,14,24,Mäßiger bis starker Regenschauer,14,14,2.2,
,2021-08-23 01:00:00,13,3,10,Mäßiger bis starker Regenschauer,13,14,1.1,
,2021-08-23 02:00:00,7,0,7,Mäßiger bis starker Regenschauer,13,13,0.4,
,2021-08-23 03:00:00,20,12,8,Mäßiger bis starker Regenschauer,13,13,0.6,
,2021-08-23 04:00:00,12,5,7,Mäßiger bis starker Regenschauer,13,13,0.3,
,2021-08-23 05:00:00,47,29,18,Stellenweiser Regenfall,13,13,0.1,
,2021-08-23 06:00:00,161,111,50,Stellenweiser Regenfall,14,14,0.1,
,2021-08-23 07:00:00,349,201,148,Stellenweiser Regenfall,15,15,0.1,
,2021-08-23 08:00:00,498,296,202,Stellenweiser Regenfall,16,16,0.2,
,2021-08-23 09:00:00,459,278,181,Stellenweiser Regenfall,17,17,0.3,
,2021-08-23 10:00:00,519,277,242,Stellenweiser Regenfall,18,18,0.2,
,2021-08-23 11:00:00,666,337,329,Stellenweiser Regenfall,19,19,0.1,
,2021-08-23 12:00:00,664,348,316,Stellenweiser Regenfall,20,20,0.1,
,2021-08-23 13:00:00,724,344,380,Stellenweiser Regenfall,20,20,0.1,
,2021-08-23 14:00:00,701,349,352,Leicht bewölkt,20,20,0.1,
,2021-08-23 15:00:00,701,365,336,Leicht bewölkt,21,21,0.2,
,2021-08-23 16:00:00,816,381,435,Leicht bewölkt,20,20,0.1,
,2021-08-23 17:00:00,904,388,516,Stellenweiser Regenfall,20,20,0.1,
,2021-08-23 18:00:00,794,345,449,Stellenweiser Regenfall,19,19,0.1,
,2021-08-23 19:00:00,548,236,312,Stellenweiser Regenfall,18,18,0,
,2021-08-23 20:00:00,403,164,239,Leicht bewölkt,17,17,0,
,2021-08-23 21:00:00,262,124,138,Leicht bewölkt,17,17,0,
,2021-08-23 22:00:00,194,84,110,Leicht bewölkt,16,16,0,
,2021-08-23 23:00:00,85,31,54,Leichter Regenschauer,15,15,0.1,
,2021-08-24 00:00:00,83,27,56,Leichter Regenschauer,14,14,0.2,
,2021-08-24 01:00:00,48,9,39,Leichter Regenschauer,13,13,0.1,
,2021-08-24 02:00:00,23,8,15,Leichter Regenschauer,13,12,0.1,
,2021-08-24 03:00:00,10,5,5,Leichter Regenschauer,13,12,0.1,
,2021-08-24 04:00:00,15,9,6,Leichter Regenschauer,12,11,0,
,2021-08-24 05:00:00,49,27,22,Leichter Nebel,12,11,0,
,2021-08-24 06:00:00,186,125,61,Leichter Nebel,12,11,0,
,2021-08-24 07:00:00,365,214,151,Leichter Nebel,13,11,0,
,2021-08-24 08:00:00,534,325,209,Stellenweiser Regenfall,13,12,0,
,2021-08-24 09:00:00,488,267,221,Stellenweiser Regenfall,13,12,0,
,2021-08-24 10:00:00,582,333,249,Stellenweiser Regenfall,14,13,0,
,2021-08-24 11:00:00,655,321,334,Bedeckt,15,15,0,
,2021-08-24 12:00:00,628,282,346,Bedeckt,16,16,0,
,2021-08-24 13:00:00,609,297,312,Bedeckt,17,17,0,
,2021-08-24 14:00:00,746,405,341,Stellenweiser Regenfall,17,17,0,
,2021-08-24 15:00:00,690,323,367,Stellenweiser Regenfall,18,18,0,
,2021-08-24 16:00:00,806,399,407,Stellenweiser Regenfall,17,17,0,
,2021-08-24 17:00:00,828,373,455,Leicht bewölkt,17,16,0,
,2021-08-24 18:00:00,779,353,426,Leicht bewölkt,16,15,0,
,2021-08-24 19:00:00,575,259,316,Leicht bewölkt,15,14,0,
,2021-08-24 20:00:00,392,194,198,Leicht bewölkt,14,13,0,
,2021-08-24 21:00:00,273,110,163,Leicht bewölkt,13,11,0,
,2021-08-24 22:00:00,188,53,135,Leicht bewölkt,13,11,0,
,2021-08-24 23:00:00,110,29,81,Bewölkt,12,11,0,
,2021-08-25 00:00:00,66,28,38,Bewölkt,12,10,0,
,2021-08-25 01:00:00,57,21,36,Bewölkt,12,10,0,
,2021-08-25 02:00:00,21,9,12,Bewölkt,12,10,0,
,2021-08-25 03:00:00,10,6,4,Bewölkt,12,10,0,
,2021-08-25 04:00:00,16,9,7,Bewölkt,12,10,0,
,2021-08-25 05:00:00,53,34,19,Leicht bewölkt,12,11,0,
,2021-08-25 06:00:00,182,125,57,Leicht bewölkt,12,11,0,
,2021-08-25 07:00:00,367,195,172,Leicht bewölkt,13,12,0,
,2021-08-25 08:00:00,484,293,191,Leicht bewölkt,14,14,0,
,2021-08-25 09:00:00,488,299,189,Leicht bewölkt,15,15,0,
,2021-08-25 10:00:00,483,285,198,Leicht bewölkt,16,16,0,
,2021-08-25 11:00:00,395,216,179,Bewölkt,17,17,0,
,2021-08-25 12:00:00,0,0,0,Bewölkt,19,19,0,
,2021-08-25 13:00:00,0,0,0,Bewölkt,19,19,0,
,2021-08-25 14:00:00,0,0,0,Leicht bewölkt,19,19,0,
,2021-08-25 15:00:00,0,0,0,Leicht bewölkt,20,20,0,
,2021-08-25 16:00:00,0,0,0,Leicht bewölkt,19,19,0,
,2021-08-25 17:00:00,0,0,0,Leicht bewölkt,18,18,0,
,2021-08-25 18:00:00,0,0,0,Leicht bewölkt,17,17,0,
,2021-08-25 19:00:00,0,0,0,Leicht bewölkt,17,17,0,
,2021-08-25 20:00:00,0,0,0,Bewölkt,16,16,0,
,2021-08-25 21:00:00,0,0,0,Bewölkt,15,15,0,
,2021-08-25 22:00:00,0,0,0,Bewölkt,13,13,0,
,2021-08-25 23:00:00,0,0,0,Leicht bewölkt,11,11,0,
,2021-08-26 00:00:00,0,0,0,Leicht bewölkt,9,9,0,
,2021-08-26 01:00:00,0,0,0,Leicht bewölkt,9,9,0,
,2021-08-26 02:00:00,0,0,0,Leicht bewölkt,8,8,0,
,2021-08-26 03:00:00,0,0,0,Leicht bewölkt,8,8,0,
,2021-08-26 04:00:00,0,0,0,Leicht bewölkt,8,8,0,
,2021-08-26 05:00:00,0,0,0,Leicht bewölkt,8,8,0,
,2021-08-26 06:00:00,0,0,0,Leicht bewölkt,8,8,0,
,2021-08-26 07:00:00,0,0,0,Leicht bewölkt,11,11,0,
,2021-08-26 08:00:00,0,0,0,Leicht bewölkt,13,13,0,
,2021-08-26 09:00:00,0,0,0,Leicht bewölkt,16,16,0,
,2021-08-26 10:00:00,0,0,0,Leicht bewölkt,17,17,0,
,2021-08-26 11:00:00,0,0,0,Leicht bewölkt,19,19,0,
,2021-08-26 12:00:00,0,0,0,Leicht bewölkt,20,20,0,
,2021-08-26 13:00:00,0,0,0,Leicht bewölkt,20,20,0,
,2021-08-26 14:00:00,0,0,0,Leicht bewölkt,21,21,0,
,2021-08-26 15:00:00,0,0,0,Leicht bewölkt,21,21,0,
,2021-08-26 16:00:00,0,0,0,Leicht bewölkt,19,19,0,
,2021-08-26 17:00:00,0,0,0,Leicht bewölkt,18,18,0,
,2021-08-26 18:00:00,0,0,0,Leicht bewölkt,17,17,0,
,2021-08-26 19:00:00,0,0,0,Leicht bewölkt,15,15,0,
,2021-08-26 20:00:00,0,0,0,Bedeckt,14,14,0,
,2021-08-26 21:00:00,0,0,0,Bedeckt,12,12,0,
,2021-08-26 22:00:00,0,0,0,Bedeckt,11,11,0,
,2021-08-26 23:00:00,0,0,0,Leichter Regenschauer,10,10,0.1,
,2021-08-27 00:00:00,0,0,0,Leichter Regenschauer,9,9,0.1,
,2021-08-27 01:00:00,0,0,0,Leichter Regenschauer,8,8,0,
,2021-08-27 02:00:00,0,0,0,Leicht bewölkt,8,8,0,
,2021-08-27 03:00:00,0,0,0,Leicht bewölkt,7,7,0,
,2021-08-27 04:00:00,0,0,0,Leicht bewölkt,7,7,0,
,2021-08-27 05:00:00,0,0,0,Leicht bewölkt,7,7,0,
,2021-08-27 06:00:00,0,0,0,Leicht bewölkt,7,7,0,
,2021-08-27 07:00:00,0,0,0,Leicht bewölkt,9,9,0,
,2021-08-27 08:00:00,0,0,0,Leicht bewölkt,11,11,0,
,2021-08-27 09:00:00,0,0,0,Leicht bewölkt,14,14,0,
,2021-08-27 10:00:00,0,0,0,Leicht bewölkt,14,14,0,
,2021-08-27 11:00:00,0,0,0,Bewölkt,15,15,0,
,2021-08-27 12:00:00,0,0,0,Bewölkt,16,16,0,
,2021-08-27 13:00:00,0,0,0,Bewölkt,16,16,0,
,2021-08-27 14:00:00,0,0,0,Leicht bewölkt,15,15,0,
,2021-08-27 15:00:00,0,0,0,Leicht bewölkt,15,15,0,
,2021-08-27 16:00:00,0,0,0,Leicht bewölkt,15,15,0,
,2021-08-27 17:00:00,0,0,0,Leicht bewölkt,15,15,0,
,2021-08-27 18:00:00,0,0,0,Leicht bewölkt,15,15,0,
,2021-08-27 19:00:00,0,0,0,Leicht bewölkt,13,14,0,
,2021-08-27 20:00:00,0,0,0,Leicht bewölkt,12,12,0,
,2021-08-27 21:00:00,0,0,0,Leicht bewölkt,10,10,0,
,2021-08-27 22:00:00,0,0,0,Leicht bewölkt,10,10,0,
,2021-08-27 23:00:00,0,0,0,Bewölkt,9,9,0,
,2021-08-28 00:00:00,0,0,0,Bewölkt,9,8,0,
,2021-08-28 01:00:00,0,0,0,Bewölkt,8,8,0,
,2021-08-28 02:00:00,0,0,0,Leicht bewölkt,8,8,0,
,2021-08-28 03:00:00,0,0,0,Leicht bewölkt,8,8,0,
,2021-08-28 04:00:00,0,0,0,Leicht bewölkt,7,7,0,
,2021-08-28 05:00:00,0,0,0,Leicht bewölkt,7,7,0,
,2021-08-28 06:00:00,0,0,0,Leicht bewölkt,7,7,0,
,2021-08-28 07:00:00,0,0,0,Leicht bewölkt,9,9,0,
,2021-08-28 08:00:00,0,0,0,Leicht bewölkt,12,12,0,
,2021-08-28 09:00:00,0,0,0,Leicht bewölkt,14,14,0,
,2021-08-28 10:00:00,0,0,0,Leicht bewölkt,15,15,0,
,2021-08-28 11:00:00,0,0,0,Bedeckt,16,16,0,
,2021-08-28 12:00:00,0,0,0,Bedeckt,17,17,0,
,2021-08-28 13:00:00,0,0,0,Bedeckt,16,16,0,
,2021-08-28 14:00:00,0,0,0,Leichter Regenschauer,16,16,0.2,
,2021-08-28 15:00:00,0,0,0,Leichter Regenschauer,15,15,0.2,
,2021-08-28 16:00:00,0,0,0,Leichter Regenschauer,14,14,0.1,
,2021-08-28 17:00:00,0,0,0,Leichter Regenschauer,13,13,0.3,
,2021-08-28 18:00:00,0,0,0,Leichter Regenschauer,13,12,0.4,
,2021-08-28 19:00:00,0,0,0,Leichter Regenschauer,12,11,0.2,
,2021-08-28 20:00:00,0,0,0,Leichter Regenschauer,11,10,0.2,
,2021-08-28 21:00:00,0,0,0,Leichter Regenschauer,10,9,0.2,
,2021-08-28 22:00:00,0,0,0,Leichter Regenschauer,10,9,0.1,
,2021-08-28 23:00:00,0,0,0,Stellenweiser Regenfall,10,9,0,
,2021-08-29 00:00:00,0,0,0,Stellenweiser Regenfall,10,10,0,
,2021-08-29 01:00:00,0,0,0,Stellenweiser Regenfall,9,9,0,
,2021-08-29 02:00:00,0,0,0,Leicht bewölkt,9,9,0,
,2021-08-29 03:00:00,0,0,0,Leicht bewölkt,8,8,0,
,2021-08-29 04:00:00,0,0,0,Leicht bewölkt,8,8,0,
,2021-08-29 05:00:00,0,0,0,Leicht bewölkt,8,8,0,
,2021-08-29 06:00:00,0,0,0,Leicht bewölkt,8,8,0,
,2021-08-29 07:00:00,0,0,0,Leicht bewölkt,9,10,0,
,2021-08-29 08:00:00,0,0,0,Bewölkt,11,12,0,
,2021-08-29 09:00:00,0,0,0,Bewölkt,13,14,0,
,2021-08-29 10:00:00,0,0,0,Bewölkt,14,15,0,
,2021-08-29 11:00:00,0,0,0,Stellenweiser Regenfall,16,16,0,
,2021-08-29 12:00:00,0,0,0,Stellenweiser Regenfall,17,17,0,
,2021-08-29 13:00:00,0,0,0,Stellenweiser Regenfall,16,16,0,
,2021-08-29 14:00:00,0,0,0,Stellenweiser Regenfall,16,16,0,
,2021-08-29 15:00:00,0,0,0,Stellenweiser Regenfall,15,15,0,
,2021-08-29 16:00:00,0,0,0,Stellenweiser Regenfall,14,14,0,
,2021-08-29 17:00:00,0,0,0,Leichter Regenschauer,13,13,0.2,
,2021-08-29 18:00:00,0,0,0,Leichter Regenschauer,12,12,0.3,
,2021-08-29 19:00:00,0,0,0,Leichter Regenschauer,12,12,0.2,
,2021-08-29 20:00:00,0,0,0,Nieselregen,12,12,0.1,
,2021-08-29 21:00:00,0,0,0,Nieselregen,11,11,0.1,
,2021-08-29 22:00:00,0,0,0,Nieselregen,11,11,0.1,
,2021-08-29 23:00:00,0,0,0,Stellenweiser Regenfall,11,11,0,
,2021-08-30 00:00:00,0,0,0,Stellenweiser Regenfall,11,11,0,
,2021-08-30 01:00:00,0,0,0,Stellenweiser Regenfall,11,11,0,
,2021-08-30 02:00:00,0,0,0,Bedeckt,11,11,0,
,2021-08-30 03:00:00,0,0,0,Bedeckt,11,11,0,
,2021-08-30 04:00:00,0,0,0,Bedeckt,11,11,0,
,2021-08-30 05:00:00,0,0,0,Leicht bewölkt,11,12,0,
,2021-08-30 06:00:00,0,0,0,Leicht bewölkt,11,12,0,
,2021-08-30 07:00:00,0,0,0,Leicht bewölkt,12,12,0,
,2021-08-30 08:00:00,0,0,0,Bewölkt,13,13,0,
,2021-08-30 09:00:00,0,0,0,Bewölkt,14,14,0,
,2021-08-30 10:00:00,0,0,0,Bewölkt,14,14,0,
,2021-08-30 11:00:00,0,0,0,Leichter Regenschauer,14,14,0.1,
,2021-08-30 12:00:00,0,0,0,Leichter Regenschauer,14,14,0.2,
,2021-08-30 13:00:00,0,0,0,Leichter Regenschauer,15,15,0.1,
,2021-08-30 14:00:00,0,0,0,Bedeckt,15,15,0,
,2021-08-30 15:00:00,0,0,0,Bedeckt,15,15,0,
,2021-08-30 16:00:00,0,0,0,Bedeckt,14,14,0,
,2021-08-30 17:00:00,0,0,0,Stellenweiser Regenfall,12,12,0.2,
,2021-08-30 18:00:00,0,0,0,Stellenweiser Regenfall,11,11,0.3,
,2021-08-30 19:00:00,0,0,0,Stellenweiser Regenfall,11,11,0.1,
,2021-08-30 20:00:00,0,0,0,Stellenweiser Regenfall,11,11,0.1,
,2021-08-30 21:00:00,0,0,0,Stellenweiser Regenfall,10,10,0.1,
,2021-08-30 22:00:00,0,0,0,Stellenweiser Regenfall,10,10,0.1,
,2021-08-30 23:00:00,0,0,0,Leichter Regenschauer,10,10,0.1,
,2021-08-31 00:00:00,0,0,0,Leichter Regenschauer,10,10,0.1,
,2021-08-31 01:00:00,0,0,0,Leichter Regenschauer,9,10,0.1,
,2021-08-31 02:00:00,0,0,0,Leichter Nebel,9,9,0,
,2021-08-31 03:00:00,0,0,0,Leichter Nebel,9,9,0,
,2021-08-31 04:00:00,0,0,0,Leichter Nebel,9,9,0,
,2021-08-31 05:00:00,0,0,0,Leichter Nebel,9,9,0,
,2021-08-31 06:00:00,0,0,0,Leichter Nebel,9,9,0,
,2021-08-31 07:00:00,0,0,0,Leichter Nebel,10,10,0,
,2021-08-31 08:00:00,0,0,0,Bedeckt,12,12,0,
,2021-08-31 09:00:00,0,0,0,Bedeckt,13,13,0,
,2021-08-31 10:00:00,0,0,0,Bedeckt,14,14,0,
,2021-08-31 11:00:00,0,0,0,Leicht bewölkt,15,15,0,
,2021-08-31 12:00:00,0,0,0,Leicht bewölkt,15,15,0,
,2021-08-31 13:00:00,0,0,0,Leicht bewölkt,17,17,0,
,2021-08-31 14:00:00,0,0,0,Stellenweiser Regenfall,18,18,0,
,2021-08-31 15:00:00,0,0,0,Stellenweiser Regenfall,19,19,0,
,2021-08-31 16:00:00,0,0,0,Stellenweiser Regenfall,18,18,0,
,2021-08-31 17:00:00,0,0,0,Stellenweiser Regenfall,16,16,0.1,
,2021-08-31 18:00:00,0,0,0,Stellenweiser Regenfall,15,15,0.1,
,2021-08-31 19:00:00,0,0,0,Stellenweiser Regenfall,15,15,0,
,2021-08-31 20:00:00,0,0,0,Leicht bewölkt,14,14,0,
,2021-08-31 21:00:00,0,0,0,Leicht bewölkt,13,13,0,
,2021-08-31 22:00:00,0,0,0,Leicht bewölkt,12,12,0,
,2021-08-31 23:00:00,0,0,0,Leicht bewölkt,10,10,0,
,2021-09-01 00:00:00,0,0,0,Leicht bewölkt,9,8,0,
,2021-09-01 01:00:00,0,0,0,Leicht bewölkt,9,8,0,
,2021-09-01 02:00:00,0,0,0,Leichter Nebel,8,8,0,
,2021-09-01 03:00:00,0,0,0,Leichter Nebel,8,8,0,
,2021-09-01 04:00:00,0,0,0,Leichter Nebel,8,7,0,
,2021-09-01 05:00:00,0,0,0,Leichter Nebel,8,7,0,
,2021-09-01 06:00:00,0,0,0,Leichter Nebel,7,7,0,
,2021-09-01 07:00:00,0,0,0,Leichter Nebel,10,9,0,
,2021-09-01 08:00:00,0,0,0,Leicht bewölkt,12,12,0,
,2021-09-01 09:00:00,0,0,0,Leicht bewölkt,14,14,0,
,2021-09-01 10:00:00,0,0,0,Leicht bewölkt,16,16,0,
,2021-09-01 11:00:00,0,0,0,Leicht bewölkt,19,18,0,
,2021-09-01 12:00:00,0,0,0,Leicht bewölkt,21,21,0,
,2021-09-01 13:00:00,0,0,0,Leicht bewölkt,21,21,0,
,2021-09-01 14:00:00,0,0,0,Leicht bewölkt,22,22,0,
,2021-09-01 15:00:00,0,0,0,Leicht bewölkt,22,22,0,
,2021-09-01 16:00:00,0,0,0,Leicht bewölkt,21,21,0,
,2021-09-01 17:00:00,0,0,0,Leicht bewölkt,19,19,0,
,2021-09-01 18:00:00,0,0,0,Leicht bewölkt,18,18,0,
,2021-09-01 19:00:00,0,0,0,Leicht bewölkt,17,17,0,
,2021-09-01 20:00:00,0,0,0,Leicht bewölkt,15,15,0,
,2021-09-01 21:00:00,0,0,0,Leicht bewölkt,14,14,0,
,2021-09-01 22:00:00,0,0,0,Leicht bewölkt,13,12,0,
,2021-09-01 23:00:00,0,0,0,Leicht bewölkt,11,11,0,
,2021-09-02 00:00:00,0,0,0,Leicht bewölkt,10,9,0,
,2021-09-02 01:00:00,0,0,0,Leicht bewölkt,9,8,0,
,2021-09-02 02:00:00,0,0,0,Sonnig,8,8,0,
,2021-09-02 03:00:00,0,0,0,Sonnig,8,7,0,
,2021-09-02 04:00:00,0,0,0,Sonnig,8,7,0,
,2021-09-02 05:00:00,0,0,0,Leicht bewölkt,7,7,0,
,2021-09-02 06:00:00,0,0,0,Leicht bewölkt,7,7,0,
,2021-09-02 07:00:00,0,0,0,Leicht bewölkt,10,9,0,
,2021-09-02 08:00:00,0,0,0,Leicht bewölkt,12,12,0,
,2021-09-02 09:00:00,0,0,0,Leicht bewölkt,15,15,0,
,2021-09-02 10:00:00,0,0,0,Leicht bewölkt,17,17,0,
,2021-09-02 11:00:00,0,0,0,Leicht bewölkt,18,18,0,
,2021-09-02 12:00:00,0,0,0,Leicht bewölkt,20,20,0,
,2021-09-02 13:00:00,0,0,0,Leicht bewölkt,21,21,0,
,2021-09-02 14:00:00,0,0,0,Leicht bewölkt,22,23,0,
,2021-09-02 15:00:00,0,0,0,Leicht bewölkt,23,25,0,
,2021-09-02 16:00:00,0,0,0,Leicht bewölkt,22,22,0,
,2021-09-02 17:00:00,0,0,0,Sonnig,21,21,0,
,2021-09-02 18:00:00,0,0,0,Sonnig,20,20,0,
,2021-09-02 19:00:00,0,0,0,Sonnig,19,19,0,
,2021-09-02 20:00:00,0,0,0,Sonnig,18,18,0,
,2021-09-02 21:00:00,0,0,0,Sonnig,18,18,0,
,2021-09-02 22:00:00,0,0,0,Sonnig,15,15,0,
,2021-09-02 23:00:00,0,0,0,Leicht bewölkt,12,12,0,
,2021-09-03 00:00:00,0,0,0,Leicht bewölkt,10,10,0,
,2021-09-03 01:00:00,0,0,0,Leicht bewölkt,9,9,0,
,2021-09-03 02:00:00,0,0,0,Leichter Nebel,9,9,0,
,2021-09-03 03:00:00,0,0,0,Leichter Nebel,9,9,0,
,2021-09-03 04:00:00,0,0,0,Leichter Nebel,9,9,0,
,2021-09-03 05:00:00,0,0,0,Leichter Nebel,8,8,0,
,2021-09-03 06:00:00,0,0,0,Leichter Nebel,8,8,0,
,2021-09-03 07:00:00,0,0,0,Leichter Nebel,11,11,0,
,2021-09-03 08:00:00,0,0,0,Leicht bewölkt,13,13,0,
,2021-09-03 09:00:00,0,0,0,Leicht bewölkt,16,16,0,
,2021-09-03 10:00:00,0,0,0,Leicht bewölkt,18,18,0,
,2021-09-03 11:00:00,0,0,0,Sonnig,20,20,0,
,2021-09-03 12:00:00,0,0,0,Sonnig,23,25,0,
,2021-09-03 13:00:00,0,0,0,Sonnig,23,25,0,
,2021-09-03 14:00:00,0,0,0,Sonnig,24,25,0,
,2021-09-03 15:00:00,0,0,0,Sonnig,25,26,0,
,2021-09-03 16:00:00,0,0,0,Sonnig,23,25,0,
,2021-09-03 17:00:00,0,0,0,Leicht bewölkt,22,22,0,
,2021-09-03 18:00:00,0,0,0,Leicht bewölkt,21,21,0,
,2021-09-03 19:00:00,0,0,0,Leicht bewölkt,20,20,0,
,2021-09-03 20:00:00,0,0,0,Leicht bewölkt,19,19,0,
,2021-09-03 21:00:00,0,0,0,Leicht bewölkt,18,18,0,
,2021-09-03 22:00:00,0,0,0,Leicht bewölkt,15,15,0,
,2021-09-03 23:00:00,0,0,0,Leicht bewölkt,13,13,0,
,2021-09-04 00:00:00,0,0,0,Leicht bewölkt,11,11,0,
,2021-09-04 01:00:00,0,0,0,Leicht bewölkt,11,11,0,
,2021-09-04 02:00:00,0,0,0,Leicht bewölkt,10,10,0,
,2021-09-04 03:00:00,0,0,0,Leicht bewölkt,10,10,0,
,2021-09-04 04:00:00,0,0,0,Leicht bewölkt,10,10,0,
,2021-09-04 05:00:00,0,0,0,Leichter Nebel,10,10,0,
,2021-09-04 06:00:00,0,0,0,Leichter Nebel,9,9,0,
,2021-09-04 07:00:00,0,0,0,Leichter Nebel,12,12,0,
,2021-09-04 08:00:00,0,0,0,Leicht bewölkt,14,14,0,
,2021-09-04 09:00:00,0,0,0,Leicht bewölkt,17,17,0,
,2021-09-04 10:00:00,0,0,0,Leicht bewölkt,19,19,0,
,2021-09-04 11:00:00,0,0,0,Sonnig,21,21,0,
,2021-09-04 12:00:00,0,0,0,Sonnig,23,25,0,
,2021-09-04 13:00:00,0,0,0,Sonnig,23,25,0,
,2021-09-04 14:00:00,0,0,0,Leicht bewölkt,23,25,0,
,2021-09-04 15:00:00,0,0,0,Leicht bewölkt,23,25,0,
,2021-09-04 16:00:00,0,0,0,Leicht bewölkt,22,22,0,
,2021-09-04 17:00:00,0,0,0,Leicht bewölkt,21,21,0,
,2021-09-04 18:00:00,0,0,0,Leicht bewölkt,19,19,0,
,2021-09-04 19:00:00,0,0,0,Leicht bewölkt,18,18,0,
,2021-09-04 20:00:00,0,0,0,Leicht bewölkt,17,17,0,
,2021-09-04 21:00:00,0,0,0,Leicht bewölkt,16,16,0,
,2021-09-04 22:00:00,0,0,0,Leicht bewölkt,15,15,0,
,2021-09-04 23:00:00,0,0,0,Leicht bewölkt,13,13,0,
,2021-09-05 00:00:00,0,0,0,Leicht bewölkt,11,11,0,
,2021-09-05 01:00:00,0,0,0,Leicht bewölkt,11,11,0,
,2021-09-05 02:00:00,0,0,0,Leicht bewölkt,11,11,0,
,2021-09-05 03:00:00,0,0,0,Leicht bewölkt,10,10,0,
,2021-09-05 04:00:00,0,0,0,Leicht bewölkt,10,10,0,
,2021-09-05 05:00:00,0,0,0,Leicht bewölkt,10,10,0,
,2021-09-05 06:00:00,0,0,0,Leicht bewölkt,10,10,0,
,2021-09-05 07:00:00,0,0,0,Leicht bewölkt,12,12,0,
,2021-09-05 08:00:00,0,0,0,Leicht bewölkt,15,15,0,
,2021-09-05 09:00:00,0,0,0,Leicht bewölkt,17,17,0,
,2021-09-05 10:00:00,0,0,0,Leicht bewölkt,19,19,0,
,2021-09-05 11:00:00,0,0,0,Leicht bewölkt,20,20,0,
,2021-09-05 12:00:00,0,0,0,Leicht bewölkt,22,25,0,
,2021-09-05 13:00:00,0,0,0,Leicht bewölkt,22,25,0,
,2021-09-05 14:00:00,0,0,0,Leicht bewölkt,22,25,0,
,2021-09-05 15:00:00,0,0,0,Leicht bewölkt,23,25,0,
,2021-09-05 16:00:00,0,0,0,Leicht bewölkt,21,21,0,
,2021-09-05 17:00:00,0,0,0,Leicht bewölkt,20,20,0,
,2021-09-05 18:00:00,0,0,0,Leicht bewölkt,19,19,0,
,2021-09-05 19:00:00,0,0,0,Leicht bewölkt,18,18,0,
,2021-09-05 20:00:00,0,0,0,Leicht bewölkt,16,16,0,
,2021-09-05 21:00:00,0,0,0,Leicht bewölkt,15,15,0,
,2021-09-05 22:00:00,0,0,0,Leicht bewölkt,14,14,0,
,2021-09-05 23:00:00,0,0,0,Leicht bewölkt,13,13,0,
,2021-09-06 00:00:00,0,0,0,Leicht bewölkt,12,12,0,
,2021-09-06 01:00:00,0,0,0,Leicht bewölkt,11,11,0,
,2021-09-06 02:00:00,0,0,0,Leicht bewölkt,11,11,0,
,2021-09-06 03:00:00,0,0,0,Leicht bewölkt,11,11,0,
,2021-09-06 04:00:00,0,0,0,Leicht bewölkt,11,11,0,
,2021-09-06 05:00:00,0,0,0,Leicht bewölkt,10,10,0,
,2021-09-06 06:00:00,0,0,0,Leicht bewölkt,10,10,0,
,2021-09-06 07:00:00,0,0,0,Leicht bewölkt,12,12,0,
,2021-09-06 08:00:00,0,0,0,Leicht bewölkt,15,15,0,
,2021-09-06 09:00:00,0,0,0,Leicht bewölkt,17,17,0,
,2021-09-06 10:00:00,0,0,0,Leicht bewölkt,19,19,0,
,2021-09-06 11:00:00,0,0,0,Leicht bewölkt,21,21,0,
,2021-09-06 12:00:00,0,0,0,Leicht bewölkt,22,25,0,
,2021-09-06 13:00:00,0,0,0,Leicht bewölkt,23,25,0,
,2021-09-06 14:00:00,0,0,0,Leicht bewölkt,23,25,0,
,2021-09-06 15:00:00,0,0,0,Leicht bewölkt,24,25,0,
,2021-09-06 16:00:00,0,0,0,Leicht bewölkt,23,25,0,
,2021-09-06 17:00:00,0,0,0,Leicht bewölkt,22,22,0,
,2021-09-06 18:00:00,0,0,0,Leicht bewölkt,21,21,0,
,2021-09-06 19:00:00,0,0,0,Leicht bewölkt,19,19,0,
,2021-09-06 20:00:00,0,0,0,Leicht bewölkt,18,18,0,
,2021-09-06 21:00:00,0,0,0,Leicht bewölkt,17,17,0,
,2021-09-06 22:00:00,0,0,0,Leicht bewölkt,15,15,0,
,2021-09-06 23:00:00,0,0,0,Leicht bewölkt,13,13,0,
,2021-09-07 00:00:00,0,0,0,Leicht bewölkt,12,12,0,
,2021-09-07 01:00:00,0,0,0,Leicht bewölkt,11,11,0,
,2021-09-07 02:00:00,0,0,0,Leicht bewölkt,11,11,0,
,2021-09-07 03:00:00,0,0,0,Leicht bewölkt,11,11,0,
,2021-09-07 04:00:00,0,0,0,Leicht bewölkt,11,11,0,
,2021-09-07 05:00:00,0,0,0,Leicht bewölkt,10,10,0,
,2021-09-07 06:00:00,0,0,0,Leicht bewölkt,10,10,0,
,2021-09-07 07:00:00,0,0,0,Leicht bewölkt,13,13,0,
,2021-09-07 08:00:00,0,0,0,Leicht bewölkt,15,15,0,
,2021-09-07 09:00:00,0,0,0,Leicht bewölkt,18,18,0,
,2021-09-07 10:00:00,0,0,0,Leicht bewölkt,19,19,0,
,2021-09-07 11:00:00,0,0,0,Leicht bewölkt,20,20,0,
,2021-09-07 12:00:00,0,0,0,Leicht bewölkt,21,21,0,
,2021-09-07 13:00:00,0,0,0,Leicht bewölkt,22,22,0,
,2021-09-07 14:00:00,0,0,0,Leicht bewölkt,22,24,0,
,2021-09-07 15:00:00,0,0,0,Leicht bewölkt,23,25,0,
,2021-09-07 16:00:00,0,0,0,Leicht bewölkt,21,21,0,
,2021-09-07 17:00:00,0,0,0,Leicht bewölkt,20,20,0,
,2021-09-07 18:00:00,0,0,0,Leicht bewölkt,18,18,0,
,2021-09-07 19:00:00,0,0,0,Leicht bewölkt,17,17,0,
,2021-09-07 20:00:00,0,0,0,Leicht bewölkt,16,16,0,
,2021-09-07 21:00:00,0,0,0,Leicht bewölkt,14,14,0,
,2021-09-07 22:00:00,0,0,0,Leicht bewölkt,13,13,0,
,2021-09-07 23:00:00,0,0,0,Sonnig,12,13,0,
,2021-09-08 00:00:00,0,0,0,Sonnig,11,12,0,
,2021-09-08 01:00:00,0,0,0,Sonnig,11,11,0,
,2021-09-08 02:00:00,0,0,0,Leicht bewölkt,11,11,0,
,2021-09-08 03:00:00,0,0,0,Leicht bewölkt,11,11,0,
,2021-09-08 04:00:00,0,0,0,Leicht bewölkt,10,11,0,
,2021-09-08 05:00:00,0,0,0,Leicht bewölkt,10,10,0,
,2021-09-08 06:00:00,0,0,0,Leicht bewölkt,10,10,0,
,2021-09-08 07:00:00,0,0,0,Leicht bewölkt,12,13,0,
,2021-09-08 08:00:00,0,0,0,Leicht bewölkt,15,15,0,
,2021-09-08 09:00:00,0,0,0,Leicht bewölkt,18,18,0,
,2021-09-08 10:00:00,0,0,0,Leicht bewölkt,20,20,0,
,2021-09-08 11:00:00,0,0,0,Leicht bewölkt,22,23,0,
,2021-09-08 12:00:00,0,0,0,Leicht bewölkt,25,26,0,
,2021-09-08 13:00:00,0,0,0,Leicht bewölkt,25,26,0,
,2021-09-08 14:00:00,0,0,0,Leicht bewölkt,26,27,0,
,2021-09-08 15:00:00,0,0,0,Leicht bewölkt,26,27,0,
,2021-09-08 16:00:00,0,0,0,Leicht bewölkt,24,25,0,
,2021-09-08 17:00:00,0,0,0,Leicht bewölkt,23,23,0,
,2021-09-08 18:00:00,0,0,0,Leicht bewölkt,21,21,0,
,2021-09-08 19:00:00,0,0,0,Leicht bewölkt,19,19,0,
,2021-09-08 20:00:00,0,0,0,Leicht bewölkt,17,17,0,
,2021-09-08 21:00:00,0,0,0,Leicht bewölkt,15,15,0,
,2021-09-08 22:00:00,0,0,0,Leicht bewölkt,15,15,0,
,2021-09-08 23:00:00,0,0,0,Leicht bewölkt,14,14,0,
,2021-09-09 00:00:00,0,0,0,Leicht bewölkt,13,14,0,
,2021-09-09 01:00:00,0,0,0,Leicht bewölkt,13,13,0,
,2021-09-09 02:00:00,0,0,0,Leicht bewölkt,13,13,0,
,2021-09-09 03:00:00,0,0,0,Leicht bewölkt,12,12,0,
,2021-09-09 04:00:00,0,0,0,Leicht bewölkt,12,13,0,
,2021-09-09 05:00:00,0,0,0,Leicht bewölkt,13,13,0,
,2021-09-09 06:00:00,0,0,0,Leicht bewölkt,13,13,0,
,2021-09-09 07:00:00,0,0,0,Leicht bewölkt,15,15,0,
,2021-09-09 08:00:00,0,0,0,Leicht bewölkt,17,18,0,
,2021-09-09 09:00:00,0,0,0,Leicht bewölkt,20,20,0,
,2021-09-09 10:00:00,0,0,0,Leicht bewölkt,21,21,0,
,2021-09-09 11:00:00,0,0,0,Leicht bewölkt,23,23,0,
,2021-09-09 12:00:00,0,0,0,Leicht bewölkt,24,25,0,
,2021-09-09 13:00:00,0,0,0,Leicht bewölkt,24,26,0,
,2021-09-09 14:00:00,0,0,0,Leicht bewölkt,25,26,0,
,2021-09-09 15:00:00,0,0,0,Leicht bewölkt,25,26,0,
,2021-09-09 16:00:00,0,0,0,Leicht bewölkt,24,24,0,
,2021-09-09 17:00:00,0,0,0,Leicht bewölkt,22,22,0,
,2021-09-09 18:00:00,0,0,0,Leicht bewölkt,20,20,0,
,2021-09-09 19:00:00,0,0,0,Leicht bewölkt,18,18,0,
,2021-09-09 20:00:00,0,0,0,Leicht bewölkt,17,17,0,
,2021-09-09 21:00:00,0,0,0,Leicht bewölkt,15,15,0,
,2021-09-09 22:00:00,0,0,0,Leicht bewölkt,14,14,0,
,2021-09-09 23:00:00,0,0,0,Leicht bewölkt,13,13,0,
,2021-09-10 00:00:00,0,0,0,Leicht bewölkt,13,13,0,
,2021-09-10 01:00:00,0,0,0,Leicht bewölkt,12,12,0,
,2021-09-10 02:00:00,0,0,0,Leicht bewölkt,12,12,0,
,2021-09-10 03:00:00,0,0,0,Leicht bewölkt,12,12,0,
,2021-09-10 04:00:00,0,0,0,Leicht bewölkt,11,11,0,
,2021-09-10 05:00:00,0,0,0,Leicht bewölkt,11,11,0,
,2021-09-10 06:00:00,0,0,0,Leicht bewölkt,11,11,0,
,2021-09-10 07:00:00,0,0,0,Leicht bewölkt,13,13,0,
,2021-09-10 08:00:00,0,0,0,Leicht bewölkt,16,16,0,
,2021-09-10 09:00:00,0,0,0,Leicht bewölkt,18,18,0,
,2021-09-10 10:00:00,0,0,0,Leicht bewölkt,20,20,0,
,2021-09-10 11:00:00,0,0,0,Leicht bewölkt,21,21,0,
,2021-09-10 12:00:00,0,0,0,Leicht bewölkt,23,25,0,
,2021-09-10 13:00:00,0,0,0,Leicht bewölkt,23,25,0,
,2021-09-10 14:00:00,0,0,0,Leicht bewölkt,24,25,0,
,2021-09-10 15:00:00,0,0,0,Leicht bewölkt,24,25,0,
,2021-09-10 16:00:00,0,0,0,Leicht bewölkt,22,23,0,
,2021-09-10 17:00:00,0,0,0,Stellenweiser Regenfall,20,20,0.1,
,2021-09-10 18:00:00,0,0,0,Stellenweiser Regenfall,18,18,0.1,
,2021-09-10 19:00:00,0,0,0,Stellenweiser Regenfall,17,17,0,
,2021-09-10 20:00:00,0,0,0,Leicht bewölkt,15,16,0,
,2021-09-10 21:00:00,0,0,0,Leicht bewölkt,14,15,0,
,2021-09-10 22:00:00,0,0,0,Leicht bewölkt,14,14,0,
,2021-09-10 23:00:00,0,0,0,Stellenweiser Regenfall,13,14,0,
,2021-09-11 00:00:00,0,0,0,Stellenweiser Regenfall,13,14,0,
,2021-09-11 01:00:00,0,0,0,Stellenweiser Regenfall,13,13,0,
,2021-09-11 02:00:00,0,0,0,Bedeckt,13,13,0,
,2021-09-11 03:00:00,0,0,0,Bedeckt,12,12,0,
,2021-09-11 04:00:00,0,0,0,Bedeckt,13,13,0,
,2021-09-11 05:00:00,0,0,0,Bedeckt,13,14,0,
,2021-09-11 06:00:00,0,0,0,Bedeckt,13,14,0,
,2021-09-11 07:00:00,0,0,0,Bedeckt,15,15,0,
,2021-09-11 08:00:00,0,0,0,Leicht bewölkt,16,16,0,
,2021-09-11 09:00:00,0,0,0,Leicht bewölkt,17,17,0,
,2021-09-11 10:00:00,0,0,0,Leicht bewölkt,18,18,0,
,2021-09-11 11:00:00,0,0,0,Leicht bewölkt,20,20,0,
,2021-09-11 12:00:00,0,0,0,Leicht bewölkt,22,22,0,
,2021-09-11 13:00:00,0,0,0,Leicht bewölkt,22,22,0,
,2021-09-11 14:00:00,0,0,0,Leicht bewölkt,22,25,0,
,2021-09-11 15:00:00,0,0,0,Leicht bewölkt,23,25,0,
,2021-09-11 16:00:00,0,0,0,Leicht bewölkt,21,21,0,
,2021-09-11 17:00:00,0,0,0,Stellenweiser Regenfall,20,20,0.1,
,2021-09-11 18:00:00,0,0,0,Stellenweiser Regenfall,18,18,0.1,
,2021-09-11 19:00:00,0,0,0,Stellenweiser Regenfall,16,16,0.1,
,2021-09-11 20:00:00,0,0,0,Bewölkt,15,15,0,
,2021-09-11 21:00:00,0,0,0,Bewölkt,13,13,0,
,2021-09-11 22:00:00,0,0,0,Bewölkt,13,13,0,
,2021-09-11 23:00:00,0,0,0,Stellenweiser Regenfall,13,13,0.1,
,2021-09-12 00:00:00,0,0,0,Stellenweiser Regenfall,12,12,0.1,
,2021-09-12 01:00:00,0,0,0,Stellenweiser Regenfall,12,12,0,
,2021-09-12 02:00:00,0,0,0,Leichter Nebel,12,12,0,
,2021-09-12 03:00:00,0,0,0,Leichter Nebel,11,11,0,
,2021-09-12 04:00:00,0,0,0,Leichter Nebel,11,11,0,
,2021-09-12 05:00:00,0,0,0,Leichter Nebel,11,11,0,
,2021-09-12 06:00:00,0,0,0,Leichter Nebel,11,11,0,
,2021-09-12 07:00:00,0,0,0,Leichter Nebel,13,13,0,
,2021-09-12 08:00:00,0,0,0,Bewölkt,15,15,0,
,2021-09-12 09:00:00,0,0,0,Bewölkt,17,17,0,
,2021-09-12 10:00:00,0,0,0,Bewölkt,19,19,0,
,2021-09-12 11:00:00,0,0,0,Leicht bewölkt,20,20,0,
,2021-09-12 12:00:00,0,0,0,Leicht bewölkt,22,25,0,
,2021-09-12 13:00:00,0,0,0,Leicht bewölkt,22,25,0,
,2021-09-12 14:00:00,0,0,0,Leicht bewölkt,22,25,0,
,2021-09-12 15:00:00,0,0,0,Leicht bewölkt,23,25,0,
,2021-09-12 16:00:00,0,0,0,Leicht bewölkt,21,21,0,
,2021-09-12 17:00:00,0,0,0,Leicht bewölkt,20,20,0,
,2021-09-12 18:00:00,0,0,0,Leicht bewölkt,18,18,0,
,2021-09-12 19:00:00,0,0,0,Leicht bewölkt,17,17,0,
,2021-09-12 20:00:00,0,0,0,Leicht bewölkt,15,16,0,
,2021-09-12 21:00:00,0,0,0,Leicht bewölkt,14,15,0,
,2021-09-12 22:00:00,0,0,0,Leicht bewölkt,13,14,0,
,2021-09-12 23:00:00,0,0,0,Leicht bewölkt,13,14,0,
,2021-09-13 00:00:00,0,0,0,Leicht bewölkt,12,13,0,
,2021-09-13 01:00:00,0,0,0,Leicht bewölkt,12,13,0,
,2021-09-13 02:00:00,0,0,0,Leicht bewölkt,12,12,0,
,2021-09-13 03:00:00,0,0,0,Leicht bewölkt,12,12,0,
,2021-09-13 04:00:00,0,0,0,Leicht bewölkt,11,11,0,
,2021-09-13 05:00:00,0,0,0,Leichter Nebel,11,11,0,
,2021-09-13 06:00:00,0,0,0,Leichter Nebel,11,11,0,
,2021-09-13 07:00:00,0,0,0,Leichter Nebel,13,13,0,
,2021-09-13 08:00:00,0,0,0,Leicht bewölkt,15,15,0,
,2021-09-13 09:00:00,0,0,0,Leicht bewölkt,18,18,0,
,2021-09-13 10:00:00,0,0,0,Leicht bewölkt,19,19,0,
,2021-09-13 11:00:00,0,0,0,Leicht bewölkt,21,21,0,
,2021-09-13 12:00:00,0,0,0,Leicht bewölkt,22,25,0,
,2021-09-13 13:00:00,0,0,0,Leicht bewölkt,22,25,0,
,2021-09-13 14:00:00,0,0,0,Leicht bewölkt,23,25,0,
,2021-09-13 15:00:00,0,0,0,Leicht bewölkt,23,25,0,
,2021-09-13 16:00:00,0,0,0,Leicht bewölkt,21,21,0,
,2021-09-13 17:00:00,0,0,0,Leicht bewölkt,20,20,0,
,2021-09-13 18:00:00,0,0,0,Leicht bewölkt,19,19,0,
,2021-09-13 19:00:00,0,0,0,Leicht bewölkt,17,17,0,
,2021-09-13 20:00:00,0,0,0,Leicht bewölkt,16,16,0,
,2021-09-13 21:00:00,0,0,0,Leicht bewölkt,14,14,0,
,2021-09-13 22:00:00,0,0,0,Leicht bewölkt,14,14,0,
,2021-09-13 23:00:00,0,0,0,Leicht bewölkt,14,14,0,
,2021-09-14 00:00:00,0,0,0,Leicht bewölkt,13,14,0,
,2021-09-14 01:00:00,0,0,0,Leicht bewölkt,13,13,0,
,2021-09-14 02:00:00,0,0,0,Leicht bewölkt,13,13,0,
,2021-09-14 03:00:00,0,0,0,Leicht bewölkt,13,13,0,
,2021-09-14 04:00:00,0,0,0,Leicht bewölkt,12,13,0,
,2021-09-14 05:00:00,0,0,0,Leicht bewölkt,12,12,0,
,2021-09-14 06:00:00,0,0,0,Leicht bewölkt,12,12,0,
,2021-09-14 07:00:00,0,0,0,Leicht bewölkt,14,14,0,
,2021-09-14 08:00:00,0,0,0,Leicht bewölkt,16,16,0,
,2021-09-14 09:00:00,0,0,0,Leicht bewölkt,18,18,0,
,2021-09-14 10:00:00,0,0,0,Leicht bewölkt,20,20,0,
,2021-09-14 11:00:00,0,0,0,Leicht bewölkt,22,22,0,
,2021-09-14 12:00:00,0,0,0,Leicht bewölkt,23,25,0,
,2021-09-14 13:00:00,0,0,0,Leicht bewölkt,23,25,0,
,2021-09-14 14:00:00,0,0,0,Leicht bewölkt,23,25,0,
,2021-09-14 15:00:00,0,0,0,Leicht bewölkt,23,25,0,
,2021-09-14 16:00:00,0,0,0,Leicht bewölkt,21,21,0,
,2021-09-14 17:00:00,0,0,0,Stellenweiser Regenfall,19,19,0.1,
,2021-09-14 18:00:00,0,0,0,Stellenweiser Regenfall,17,17,0.1,
,2021-09-14 19:00:00,0,0,0,Stellenweiser Regenfall,17,17,0,
,2021-09-14 20:00:00,0,0,0,Stellenweiser Regenfall,16,16,0,
,2021-09-14 21:00:00,0,0,0,Stellenweiser Regenfall,15,15,0,
,2021-09-14 22:00:00,0,0,0,Stellenweiser Regenfall,16,16,0,
,2021-09-14 23:00:00,0,0,0,Stellenweiser Regenfall,16,16,0.2,
,2021-09-15 00:00:00,0,0,0,Stellenweiser Regenfall,17,17,0.3,
,2021-09-15 01:00:00,0,0,0,Stellenweiser Regenfall,16,16,0.2,
,2021-09-15 02:00:00,0,0,0,Leicht bewölkt,16,16,0,
,2021-09-15 03:00:00,0,0,0,Leicht bewölkt,16,16,0,
,2021-09-15 04:00:00,0,0,0,Leicht bewölkt,16,16,0,
,2021-09-15 05:00:00,0,0,0,Leicht bewölkt,15,16,0,
,2021-09-15 06:00:00,0,0,0,Leicht bewölkt,15,16,0,
,2021-09-15 07:00:00,0,0,0,Leicht bewölkt,16,17,0,
,2021-09-15 08:00:00,0,0,0,Leicht bewölkt,18,18,0,
,2021-09-15 09:00:00,0,0,0,Leicht bewölkt,19,19,0,
,2021-09-15 10:00:00,0,0,0,Leicht bewölkt,20,20,0,
,2021-09-15 11:00:00,0,0,0,Leicht bewölkt,21,21,0,
,2021-09-15 12:00:00,0,0,0,Leicht bewölkt,22,25,0,
,2021-09-15 13:00:00,0,0,0,Leicht bewölkt,22,25,0,
,2021-09-15 14:00:00,0,0,0,Leicht bewölkt,22,25,0,
,2021-09-15 15:00:00,0,0,0,Leicht bewölkt,22,25,0,
,2021-09-15 16:00:00,0,0,0,Leicht bewölkt,21,21,0,
,2021-09-15 17:00:00,0,0,0,Leicht bewölkt,20,20,0,
,2021-09-15 18:00:00,0,0,0,Leicht bewölkt,19,19,0,
,2021-09-15 19:00:00,0,0,0,Leicht bewölkt,18,18,0,
,2021-09-15 20:00:00,0,0,0,Stellenweiser Regenfall,17,17,0.1,
,2021-09-15 21:00:00,0,0,0,Stellenweiser Regenfall,16,16,0.1,
,2021-09-15 22:00:00,0,0,0,Stellenweiser Regenfall,16,16,0,
,2021-09-15 23:00:00,0,0,0,Leichter Regenschauer,16,16,0.1,
,2021-09-16 00:00:00,0,0,0,Leichter Regenschauer,16,16,0.1,
,2021-09-16 01:00:00,0,0,0,Leichter Regenschauer,15,15,0.1,
,2021-09-16 02:00:00,0,0,0,Leichter Nebel,15,15,0,
,2021-09-16 03:00:00,0,0,0,Leichter Nebel,15,15,0,
,2021-09-16 04:00:00,0,0,0,Leichter Nebel,15,15,0,
,2021-09-16 05:00:00,0,0,0,Leichter Nebel,15,15,0,
,2021-09-16 06:00:00,0,0,0,Leichter Nebel,15,15,0,
,2021-09-16 07:00:00,0,0,0,Leichter Nebel,16,16,0,
,2021-09-16 08:00:00,0,0,0,Bewölkt,17,17,0,
,2021-09-16 09:00:00,0,0,0,Bewölkt,18,18,0,
,2021-09-16 10:00:00,0,0,0,Bewölkt,18,18,0,
,2021-09-16 11:00:00,0,0,0,Leichter Regenschauer,18,18,0.1,
,2021-09-16 12:00:00,0,0,0,Leichter Regenschauer,18,18,0.1,
,2021-09-16 13:00:00,0,0,0,Leichter Regenschauer,18,18,0.1,
,2021-09-16 14:00:00,0,0,0,Leichter Regenschauer,17,17,0.4,
,2021-09-16 15:00:00,0,0,0,Leichter Regenschauer,17,17,0.5,
,2021-09-16 16:00:00,0,0,0,Leichter Regenschauer,17,17,0.2,
,2021-09-16 17:00:00,0,0,0,Leichter Regenschauer,17,17,0.3,
,2021-09-16 18:00:00,0,0,0,Leichter Regenschauer,17,17,0.4,
,2021-09-16 19:00:00,0,0,0,Leichter Regenschauer,16,16,0.2,
,2021-09-16 20:00:00,0,0,0,Leichter Nebel,15,16,0,
,2021-09-16 21:00:00,0,0,0,Leichter Nebel,15,15,0,
,2021-09-16 22:00:00,0,0,0,Leichter Nebel,14,15,0,
,2021-09-16 23:00:00,0,0,0,Leichter Regenschauer,14,14,0.8,
,2021-09-17 00:00:00,0,0,0,Leichter Regenschauer,14,14,1.1,
,2021-09-17 01:00:00,0,0,0,Leichter Regenschauer,14,13,0.5,
,2021-09-17 02:00:00,0,0,0,Leichter Regenschauer,13,13,0.1,
,2021-09-17 03:00:00,0,0,0,Leichter Regenschauer,13,13,0.1,
,2021-09-17 04:00:00,0,0,0,Leichter Regenschauer,13,13,0,
,2021-09-17 05:00:00,0,0,0,Leichter Nebel,13,13,0,
,2021-09-17 06:00:00,0,0,0,Leichter Nebel,12,12,0,
,2021-09-17 07:00:00,0,0,0,Leichter Nebel,13,13,0,
,2021-09-17 08:00:00,0,0,0,Stellenweiser Nieselregen,14,14,0.1,
,2021-09-17 09:00:00,0,0,0,Stellenweiser Nieselregen,14,14,0.1,
,2021-09-17 10:00:00,0,0,0,Stellenweiser Nieselregen,15,15,0,
,2021-09-17 11:00:00,0,0,0,Stellenweiser Regenfall,15,15,0,
,2021-09-17 12:00:00,0,0,0,Stellenweiser Regenfall,15,15,0,
,2021-09-17 13:00:00,0,0,0,Stellenweiser Regenfall,17,17,0,
,2021-09-17 14:00:00,0,0,0,Leicht bewölkt,18,18,0,
,2021-09-17 15:00:00,0,0,0,Leicht bewölkt,19,19,0,
,2021-09-17 16:00:00,0,0,0,Leicht bewölkt,18,18,0,
,2021-09-17 17:00:00,0,0,0,Bewölkt,16,16,0,
,2021-09-17 18:00:00,0,0,0,Bewölkt,15,15,0,
,2021-09-17 19:00:00,0,0,0,Bewölkt,14,14,0,
,2021-09-17 20:00:00,0,0,0,Leicht bewölkt,14,14,0,
,2021-09-17 21:00:00,0,0,0,Leicht bewölkt,13,13,0,
,2021-09-17 22:00:00,0,0,0,Leicht bewölkt,13,13,0,
,2021-09-17 23:00:00,0,0,0,Leicht bewölkt,12,12,0,
,2021-09-18 00:00:00,0,0,0,Leicht bewölkt,12,12,0,
,2021-09-18 01:00:00,0,0,0,Leicht bewölkt,11,11,0,
,2021-09-18 02:00:00,0,0,0,Leicht bewölkt,11,11,0,
,2021-09-18 03:00:00,0,0,0,Leicht bewölkt,11,11,0,
,2021-09-18 04:00:00,0,0,0,Leicht bewölkt,10,10,0,
,2021-09-18 05:00:00,0,0,0,Bewölkt,10,10,0,
,2021-09-18 06:00:00,0,0,0,Bewölkt,10,10,0,
,2021-09-18 07:00:00,0,0,0,Bewölkt,12,12,0,
,2021-09-18 08:00:00,0,0,0,Leicht bewölkt,14,14,0,
,2021-09-18 09:00:00,0,0,0,Leicht bewölkt,16,16,0,
,2021-09-18 10:00:00,0,0,0,Leicht bewölkt,17,17,0,
,2021-09-18 11:00:00,0,0,0,Leicht bewölkt,19,19,0,
,2021-09-18 12:00:00,0,0,0,Leicht bewölkt,20,20,0,
,2021-09-18 13:00:00,0,0,0,Leicht bewölkt,20,20,0,
,2021-09-18 14:00:00,0,0,0,Leicht bewölkt,20,20,0,
,2021-09-18 15:00:00,0,0,0,Leicht bewölkt,20,20,0,
,2021-09-18 16:00:00,0,0,0,Leicht bewölkt,18,18,0,
,2021-09-18 17:00:00,0,0,0,Leichter Regenschauer,16,17,0.1,
,2021-09-18 18:00:00,0,0,0,Leichter Regenschauer,15,15,0.1,
,2021-09-18 19:00:00,0,0,0,Leichter Regenschauer,14,14,0.1,
,2021-09-18 20:00:00,0,0,0,Leichter Regenschauer,13,14,0.1,
,2021-09-18 21:00:00,0,0,0,Leichter Regenschauer,13,13,0.1,
,2021-09-18 22:00:00,0,0,0,Leichter Regenschauer,12,12,0,
,2021-09-18 23:00:00,0,0,0,Leicht bewölkt,11,11,0,
,2021-09-19 00:00:00,0,0,0,Leicht bewölkt,9,9,0,
,2021-09-19 01:00:00,0,0,0,Leicht bewölkt,9,9,0,
,2021-09-19 02:00:00,0,0,0,Leicht bewölkt,9,8,0,
,2021-09-19 03:00:00,0,0,0,Leicht bewölkt,8,8,0,
,2021-09-19 04:00:00,0,0,0,Leicht bewölkt,8,7,0,
,2021-09-19 05:00:00,0,0,0,Leichter Nebel,8,7,0,
,2021-09-19 06:00:00,0,0,0,Leichter Nebel,7,6,0,
,2021-09-19 07:00:00,0,0,0,Leichter Nebel,9,8,0,
,2021-09-19 08:00:00,0,0,0,Leicht bewölkt,12,11,0,
,2021-09-19 09:00:00,0,0,0,Leicht bewölkt,14,13,0,
,2021-09-19 10:00:00,0,0,0,Leicht bewölkt,15,14,0,
,2021-09-19 11:00:00,0,0,0,Leicht bewölkt,16,16,0,
,2021-09-19 12:00:00,0,0,0,Leicht bewölkt,18,18,0,
,2021-09-19 13:00:00,0,0,0,Leicht bewölkt,17,17,0,
,2021-09-19 14:00:00,0,0,0,Bewölkt,17,17,0,
,2021-09-19 15:00:00,0,0,0,Bewölkt,17,17,0,
,2021-09-19 16:00:00,0,0,0,Bewölkt,16,16,0,
,2021-09-19 17:00:00,0,0,0,Stellenweiser Regenfall,16,16,0,
,2021-09-19 18:00:00,0,0,0,Stellenweiser Regenfall,15,15,0,
,2021-09-19 19:00:00,0,0,0,Stellenweiser Regenfall,14,14,0,
,2021-09-19 20:00:00,0,0,0,Leichter Regenschauer,14,14,0.1,
,2021-09-19 21:00:00,0,0,0,Leichter Regenschauer,13,13,0.1,
,2021-09-19 22:00:00,0,0,0,Leichter Regenschauer,12,12,0,
,2021-09-19 23:00:00,0,0,0,Stellenweiser Regenfall,11,11,0.1,
,2021-09-20 00:00:00,0,0,0,Stellenweiser Regenfall,10,11,0.2,
,2021-09-20 01:00:00,0,0,0,Stellenweiser Regenfall,10,10,0.1,
,2021-09-20 02:00:00,0,0,0,Leicht bewölkt,9,9,0,
,2021-09-20 03:00:00,0,0,0,Leicht bewölkt,8,8,0,
,2021-09-20 04:00:00,0,0,0,Leicht bewölkt,8,8,0,
,2021-09-20 05:00:00,0,0,0,Leicht bewölkt,8,8,0,
,2021-09-20 06:00:00,0,0,0,Leicht bewölkt,8,8,0,
,2021-09-20 07:00:00,0,0,0,Leicht bewölkt,9,9,0,
,2021-09-20 08:00:00,0,0,0,Bewölkt,10,10,0,
,2021-09-20 09:00:00,0,0,0,Bewölkt,11,11,0,
,2021-09-20 10:00:00,0,0,0,Bewölkt,11,11,0,
,2021-09-20 11:00:00,0,0,0,Leicht bewölkt,12,12,0,
,2021-09-20 12:00:00,0,0,0,Leicht bewölkt,13,13,0,
,2021-09-20 13:00:00,0,0,0,Leicht bewölkt,13,13,0,
,2021-09-20 14:00:00,0,0,0,Leicht bewölkt,13,13,0,
,2021-09-20 15:00:00,0,0,0,Leicht bewölkt,14,13,0,
,2021-09-20 16:00:00,0,0,0,Leicht bewölkt,13,13,0,
,2021-09-20 17:00:00,0,0,0,Bedeckt,13,12,0,
,2021-09-20 18:00:00,0,0,0,Bedeckt,12,12,0,
,2021-09-20 19:00:00,0,0,0,Bedeckt,11,11,0,
,2021-09-20 20:00:00,0,0,0,Bedeckt,11,11,0,
,2021-09-20 21:00:00,0,0,0,Bedeckt,10,10,0,
,2021-09-20 22:00:00,0,0,0,Bedeckt,10,10,0,
,2021-09-20 23:00:00,0,0,0,Leicht bewölkt,9,9,0,
,2021-09-21 00:00:00,0,0,0,Leicht bewölkt,9,9,0,
,2021-09-21 01:00:00,0,0,0,Leicht bewölkt,9,9,0,
,2021-09-21 02:00:00,0,0,0,Leicht bewölkt,8,8,0,
,2021-09-21 03:00:00,0,0,0,Leicht bewölkt,8,8,0,
,2021-09-21 04:00:00,0,0,0,Leicht bewölkt,7,7,0,
,2021-09-21 05:00:00,0,0,0,Leicht bewölkt,7,7,0,
,2021-09-21 06:00:00,0,0,0,Leicht bewölkt,7,7,0,
,2021-09-21 07:00:00,0,0,0,Leicht bewölkt,9,9,0,
,2021-09-21 08:00:00,0,0,0,Leicht bewölkt,11,11,0,
,2021-09-21 09:00:00,0,0,0,Leicht bewölkt,13,13,0,
,2021-09-21 10:00:00,0,0,0,Leicht bewölkt,14,14,0,
,2021-09-21 11:00:00,0,0,0,Leicht bewölkt,16,16,0,
,2021-09-21 12:00:00,0,0,0,Leicht bewölkt,18,18,0,
,2021-09-21 13:00:00,0,0,0,Leicht bewölkt,18,18,0,
,2021-09-21 14:00:00,0,0,0,Leicht bewölkt,18,18,0,
,2021-09-21 15:00:00,0,0,0,Leicht bewölkt,18,18,0,
,2021-09-21 16:00:00,0,0,0,Leicht bewölkt,16,16,0,
,2021-09-21 17:00:00,0,0,0,Leicht bewölkt,14,14,0,
,2021-09-21 18:00:00,0,0,0,Leicht bewölkt,13,12,0,
,2021-09-21 19:00:00,0,0,0,Leicht bewölkt,11,11,0,
,2021-09-21 20:00:00,0,0,0,Leicht bewölkt,10,10,0,
,2021-09-21 21:00:00,0,0,0,Leicht bewölkt,9,9,0,
,2021-09-21 22:00:00,0,0,0,Leicht bewölkt,8,8,0,
,2021-09-21 23:00:00,0,0,0,Leicht bewölkt,8,7,0,
,2021-09-22 00:00:00,0,0,0,Leicht bewölkt,7,6,0,
,2021-09-22 01:00:00,0,0,0,Leicht bewölkt,7,6,0,
,2021-09-22 02:00:00,0,0,0,Leicht bewölkt,6,6,0,
,2021-09-22 03:00:00,0,0,0,Leicht bewölkt,6,5,0,
,2021-09-22 04:00:00,0,0,0,Leicht bewölkt,6,5,0,
,2021-09-22 05:00:00,0,0,0,Leicht bewölkt,6,5,0,
,2021-09-22 06:00:00,0,0,0,Leicht bewölkt,6,5,0,
,2021-09-22 07:00:00,0,0,0,Leicht bewölkt,8,7,0,
,2021-09-22 08:00:00,0,0,0,Leicht bewölkt,10,9,0,
,2021-09-22 09:00:00,0,0,0,Leicht bewölkt,12,12,0,
,2021-09-22 10:00:00,0,0,0,Leicht bewölkt,13,13,0,
,2021-09-22 11:00:00,0,0,0,Leicht bewölkt,14,14,0,
,2021-09-22 12:00:00,0,0,0,Leicht bewölkt,16,16,0,
,2021-09-22 13:00:00,0,0,0,Leicht bewölkt,17,17,0,
,2021-09-22 14:00:00,0,0,0,Leicht bewölkt,17,17,0,
,2021-09-22 15:00:00,0,0,0,Leicht bewölkt,18,18,0,
,2021-09-22 16:00:00,0,0,0,Leicht bewölkt,17,16,0,
,2021-09-22 17:00:00,0,0,0,Leicht bewölkt,15,14,0,
,2021-09-22 18:00:00,0,0,0,Leicht bewölkt,14,13,0,
,2021-09-22 19:00:00,0,0,0,Leicht bewölkt,12,11,0,
,2021-09-22 20:00:00,0,0,0,Leicht bewölkt,10,9,0,
,2021-09-22 21:00:00,0,0,0,Leicht bewölkt,8,7,0,
,2021-09-22 22:00:00,0,0,0,Leicht bewölkt,7,6,0,
,2021-09-22 23:00:00,0,0,0,Sonnig,7,6,0,
,2021-09-23 00:00:00,0,0,0,Sonnig,6,6,0,
,2021-09-23 01:00:00,0,0,0,Sonnig,6,5,0,
,2021-09-23 02:00:00,0,0,0,Leicht bewölkt,5,5,0,
,2021-09-23 03:00:00,0,0,0,Leicht bewölkt,5,5,0,
,2021-09-23 04:00:00,0,0,0,Leicht bewölkt,5,5,0,
,2021-09-23 05:00:00,0,0,0,Leichter Nebel,4,4,0,
,2021-09-23 06:00:00,0,0,0,Leichter Nebel,4,4,0,
,2021-09-23 07:00:00,0,0,0,Leichter Nebel,7,7,0,
,2021-09-23 08:00:00,0,0,0,Leicht bewölkt,9,9,0,
,2021-09-23 09:00:00,0,0,0,Leicht bewölkt,11,11,0,
,2021-09-23 10:00:00,0,0,0,Leicht bewölkt,14,14,0,
,2021-09-23 11:00:00,0,0,0,Sonnig,16,16,0,
,2021-09-23 12:00:00,0,0,0,Sonnig,18,18,0,
,2021-09-23 13:00:00,0,0,0,Sonnig,19,19,0,
,2021-09-23 14:00:00,0,0,0,Sonnig,20,20,0,
,2021-09-23 15:00:00,0,0,0,Sonnig,20,20,0,
,2021-09-23 16:00:00,0,0,0,Sonnig,19,19,0,
,2021-09-23 17:00:00,0,0,0,Sonnig,17,17,0,
,2021-09-23 18:00:00,0,0,0,Sonnig,15,15,0,
,2021-09-23 19:00:00,0,0,0,Sonnig,13,13,0,
,2021-09-23 20:00:00,0,0,0,Sonnig,11,11,0,
,2021-09-23 21:00:00,0,0,0,Sonnig,10,9,0,
,2021-09-23 22:00:00,0,0,0,Sonnig,9,9,0,
,2021-09-23 23:00:00,0,0,0,Leicht bewölkt,9,9,0,
,2021-09-24 00:00:00,0,0,0,Leicht bewölkt,9,9,0,
,2021-09-24 01:00:00,0,0,0,Leicht bewölkt,9,9,0,
,2021-09-24 02:00:00,0,0,0,Leicht bewölkt,8,8,0,
,2021-09-24 03:00:00,0,0,0,Leicht bewölkt,8,8,0,
,2021-09-24 04:00:00,0,0,0,Leicht bewölkt,8,8,0,
,2021-09-24 05:00:00,0,0,0,Leicht bewölkt,8,8,0,
,2021-09-24 06:00:00,0,0,0,Leicht bewölkt,7,7,0,
,2021-09-24 07:00:00,0,0,0,Leicht bewölkt,10,10,0,
,2021-09-24 08:00:00,0,0,0,Leicht bewölkt,12,12,0,
,2021-09-24 09:00:00,0,0,0,Leicht bewölkt,14,14,0,
,2021-09-24 10:00:00,0,0,0,Leicht bewölkt,16,16,0,
,2021-09-24 11:00:00,0,0,0,Leicht bewölkt,18,18,0,
,2021-09-24 12:00:00,0,0,0,Leicht bewölkt,21,21,0,
,2021-09-24 13:00:00,0,0,0,Leicht bewölkt,21,21,0,
,2021-09-24 14:00:00,0,0,0,Sonnig,22,23,0,
,2021-09-24 15:00:00,0,0,0,Sonnig,23,25,0,
,2021-09-24 16:00:00,0,0,0,Sonnig,21,21,0,
,2021-09-24 17:00:00,0,0,0,Sonnig,19,19,0,
,2021-09-24 18:00:00,0,0,0,Sonnig,17,17,0,
,2021-09-24 19:00:00,0,0,0,Sonnig,15,15,0,
,2021-09-24 20:00:00,0,0,0,Sonnig,13,13,0,
,2021-09-24 21:00:00,0,0,0,Sonnig,11,11,0,
,2021-09-24 22:00:00,0,0,0,Sonnig,10,10,0,
,2021-09-24 23:00:00,0,0,0,Sonnig,10,10,0,
,2021-09-25 00:00:00,0,0,0,Sonnig,10,10,0,
,2021-09-25 01:00:00,0,0,0,Sonnig,9,9,0,
,2021-09-25 02:00:00,0,0,0,Sonnig,9,9,0,
,2021-09-25 03:00:00,0,0,0,Sonnig,9,9,0,
,2021-09-25 04:00:00,0,0,0,Sonnig,9,9,0,
,2021-09-25 05:00:00,0,0,0,Leicht bewölkt,8,8,0,
,2021-09-25 06:00:00,0,0,0,Leicht bewölkt,8,8,0,
,2021-09-25 07:00:00,0,0,0,Leicht bewölkt,10,10,0,
,2021-09-25 08:00:00,0,0,0,Leicht bewölkt,12,12,0,
,2021-09-25 09:00:00,0,0,0,Leicht bewölkt,15,15,0,
,2021-09-25 10:00:00,0,0,0,Leicht bewölkt,17,17,0,
,2021-09-25 11:00:00,0,0,0,Leicht bewölkt,19,19,0,
,2021-09-25 12:00:00,0,0,0,Leicht bewölkt,20,20,0,
,2021-09-25 13:00:00,0,0,0,Leicht bewölkt,21,21,0,
,2021-09-25 14:00:00,0,0,0,Leicht bewölkt,22,22,0,
,2021-09-25 15:00:00,0,0,0,Leicht bewölkt,23,25,0,
,2021-09-25 16:00:00,0,0,0,Leicht bewölkt,20,20,0,
,2021-09-25 17:00:00,0,0,0,Leicht bewölkt,18,18,0,
,2021-09-25 18:00:00,0,0,0,Leicht bewölkt,16,16,0,
,2021-09-25 19:00:00,0,0,0,Leicht bewölkt,15,15,0,
,2021-09-25 20:00:00,0,0,0,Leicht bewölkt,14,14,0,
,2021-09-25 21:00:00,0,0,0,Leicht bewölkt,13,13,0,
,2021-09-25 22:00:00,0,0,0,Leicht bewölkt,13,13,0,
,2021-09-25 23:00:00,0,0,0,Leicht bewölkt,13,13,0,
,2021-09-26 00:00:00,,,,Leicht bewölkt,13,13,0,
,2021-09-26 01:00:00,,,,Leicht bewölkt,13,13,0,
,2021-09-26 02:00:00,,,,Leicht bewölkt,13,13,0,
,2021-09-26 03:00:00,,,,Leicht bewölkt,13,14,0,
,2021-09-26 04:00:00,,,,Leicht bewölkt,13,13,0,
,2021-09-26 05:00:00,,,,Leicht bewölkt,12,13,0,
,2021-09-26 06:00:00,,,,Leicht bewölkt,12,12,0,
,2021-09-26 07:00:00,,,,Leicht bewölkt,14,14,0,
,2021-09-26 08:00:00,,,,Leicht bewölkt,16,16,0,
,2021-09-26 09:00:00,,,,Leicht bewölkt,18,18,0,
,2021-09-26 10:00:00,,,,Leicht bewölkt,20,20,0,
,2021-09-26 11:00:00,,,,Leicht bewölkt,21,21,0,
,2021-09-26 12:00:00,,,,Leicht bewölkt,23,25,0,
,2021-09-26 13:00:00,,,,Leicht bewölkt,23,25,0,
,2021-09-26 14:00:00,,,,Stellenweise Gewitter und Niederschläge,23,25,0,
,2021-09-26 15:00:00,,,,Stellenweise Gewitter und Niederschläge,23,25,0,
,2021-09-26 16:00:00,,,,Stellenweise Gewitter und Niederschläge,21,21,0,
,2021-09-26 17:00:00,,,,Leichter Regenschauer,19,19,0.3,
,2021-09-26 18:00:00,,,,Leichter Regenschauer,16,16,0.4,
,2021-09-26 19:00:00,,,,Leichter Regenschauer,15,15,0.2,
,2021-09-26 20:00:00,,,,Leichter Regenschauer,14,14,0.5,
,2021-09-26 21:00:00,,,,Leichter Regenschauer,13,12,0.7,
,2021-09-26 22:00:00,,,,Leichter Regenschauer,13,13,0.4,
,2021-09-26 23:00:00,,,,Leichter Regenschauer,13,13,0.1,
,2021-09-27 00:00:00,,,,Leichter Regenschauer,13,13,0.1,
,2021-09-27 01:00:00,,,,Leichter Regenschauer,13,13,0,
,2021-09-27 02:00:00,,,,Leicht bewölkt,12,13,0,
,2021-09-27 03:00:00,,,,Leicht bewölkt,12,12,0,
,2021-09-27 04:00:00,,,,Leicht bewölkt,11,12,0,
,2021-09-27 05:00:00,,,,Leicht bewölkt,11,12,0,
,2021-09-27 06:00:00,,,,Leicht bewölkt,11,11,0,
,2021-09-27 07:00:00,,,,Leicht bewölkt,12,12,0,
,2021-09-27 08:00:00,,,,Bewölkt,14,14,0,
,2021-09-27 09:00:00,,,,Bewölkt,15,15,0,
,2021-09-27 10:00:00,,,,Bewölkt,17,17,0,
,2021-09-27 11:00:00,,,,Stellenweiser Regenfall,18,18,0,
,2021-09-27 12:00:00,,,,Stellenweiser Regenfall,19,19,0,
,2021-09-27 13:00:00,,,,Stellenweiser Regenfall,20,20,0,
,2021-09-27 14:00:00,,,,Leicht bewölkt,20,20,0,
,2021-09-27 15:00:00,,,,Leicht bewölkt,21,21,0,
,2021-09-27 16:00:00,,,,Leicht bewölkt,19,19,0,
,2021-09-27 17:00:00,,,,Stellenweiser Regenfall,17,17,0.2,
,2021-09-27 18:00:00,,,,Stellenweiser Regenfall,15,15,0.2,
,2021-09-27 19:00:00,,,,Stellenweiser Regenfall,15,15,0.1,
,2021-09-27 20:00:00,,,,Leichter Regenschauer,14,14,0.1,
,2021-09-27 21:00:00,,,,Leichter Regenschauer,14,14,0.1,
,2021-09-27 22:00:00,,,,Leichter Regenschauer,13,13,0.1,
,2021-09-27 23:00:00,,,,Leicht bewölkt,12,13,0,
,2021-09-28 00:00:00,,,,Leicht bewölkt,12,12,0,
,2021-09-28 01:00:00,,,,Leicht bewölkt,11,11,0,
,2021-09-28 02:00:00,,,,Leicht bewölkt,11,11,0,
,2021-09-28 03:00:00,,,,Leicht bewölkt,11,11,0,
,2021-09-28 04:00:00,,,,Leicht bewölkt,10,10,0,
,2021-09-28 05:00:00,,,,Leichter Nebel,10,10,0,
,2021-09-28 06:00:00,,,,Leichter Nebel,10,10,0,
,2021-09-28 07:00:00,,,,Leichter Nebel,12,12,0,
,2021-09-28 08:00:00,,,,Leicht bewölkt,14,14,0,
,2021-09-28 09:00:00,,,,Leicht bewölkt,16,16,0,
,2021-09-28 10:00:00,,,,Leicht bewölkt,17,17,0,
,2021-09-28 11:00:00,,,,Leicht bewölkt,18,18,0,
,2021-09-28 12:00:00,,,,Leicht bewölkt,20,20,0,
,2021-09-28 13:00:00,,,,Leicht bewölkt,20,20,0,
,2021-09-28 14:00:00,,,,Leicht bewölkt,21,21,0,
,2021-09-28 15:00:00,,,,Leicht bewölkt,21,21,0,
,2021-09-28 16:00:00,,,,Leicht bewölkt,19,19,0,
,2021-09-28 17:00:00,,,,Leicht bewölkt,17,17,0,
,2021-09-28 18:00:00,,,,Leicht bewölkt,16,16,0,
,2021-09-28 19:00:00,,,,Leicht bewölkt,15,15,0,
,2021-09-28 20:00:00,,,,Leichter Regenschauer,14,14,0.1,
,2021-09-28 21:00:00,,,,Leichter Regenschauer,14,14,0.1,
,2021-09-28 22:00:00,,,,Leichter Regenschauer,13,13,0,
,2021-09-28 23:00:00,,,,Leichter Regenschauer,13,13,0.3,
,2021-09-29 00:00:00,,,,Leichter Regenschauer,12,12,0.5,
,2021-09-29 01:00:00,,,,Leichter Regenschauer,13,13,0.3,
,2021-09-29 02:00:00,,,,Leichter Regenschauer,13,13,0.1,
,2021-09-29 03:00:00,,,,Leichter Regenschauer,13,14,0.1,
,2021-09-29 04:00:00,,,,Leichter Regenschauer,13,13,0,
,2021-09-29 05:00:00,,,,Stellenweiser Regenfall,13,12,0.1,
,2021-09-29 06:00:00,,,,Stellenweiser Regenfall,12,12,0.2,
,2021-09-29 07:00:00,,,,Stellenweiser Regenfall,13,12,0.1,
,2021-09-29 08:00:00,,,,Leicht bewölkt,13,12,0,
,2021-09-29 09:00:00,,,,Leicht bewölkt,13,12,0,
,2021-09-29 10:00:00,,,,Leicht bewölkt,14,14,0,
,2021-09-29 11:00:00,,,,Bewölkt,16,15,0,
,2021-09-29 12:00:00,,,,Bewölkt,17,17,0,
,2021-09-29 13:00:00,,,,Bewölkt,17,17,0,
,2021-09-29 14:00:00,,,,Leicht bewölkt,18,18,0,
,2021-09-29 15:00:00,,,,Leicht bewölkt,18,18,0,
,2021-09-29 16:00:00,,,,Leicht bewölkt,17,17,0,
,2021-09-29 17:00:00,,,,Stellenweiser Regenfall,15,15,0,
,2021-09-29 18:00:00,,,,Stellenweiser Regenfall,14,13,0,
,2021-09-29 19:00:00,,,,Stellenweiser Regenfall,13,13,0,
,2021-09-29 20:00:00,,,,Bewölkt,13,13,0,
,2021-09-29 21:00:00,,,,Bewölkt,12,13,0,
,2021-09-29 22:00:00,,,,Bewölkt,11,12,0,
,2021-09-29 23:00:00,,,,Leichter Regenschauer,10,10,0.1,
,2021-09-30 00:00:00,,,,Leichter Regenschauer,10,9,0.2,
,2021-09-30 01:00:00,,,,Leichter Regenschauer,9,9,0.1,
,2021-09-30 02:00:00,,,,Stellenweiser Regenfall,9,9,0,
,2021-09-30 03:00:00,,,,Stellenweiser Regenfall,9,8,0,
,2021-09-30 04:00:00,,,,Stellenweiser Regenfall,8,7,0,
,2021-09-30 05:00:00,0,0,0,Leicht bewölkt,7,7,0,
,2021-09-30 06:00:00,0,0,0,Leicht bewölkt,6,6,0,
,2021-09-30 07:00:00,0,0,0,Leicht bewölkt,8,7,0,
,2021-09-30 08:00:00,0,0,0,Leicht bewölkt,9,8,0,
,2021-09-30 09:00:00,0,0,0,Leicht bewölkt,10,10,0,
,2021-09-30 10:00:00,0,0,0,Leicht bewölkt,12,11,0,
,2021-09-30 11:00:00,0,0,0,Leicht bewölkt,13,13,0,
,2021-09-30 12:00:00,0,0,0,Leicht bewölkt,15,15,0,
,2021-09-30 13:00:00,0,0,0,Leicht bewölkt,15,15,0,
,2021-09-30 14:00:00,427,210,217,Leicht bewölkt,15,15,0,
,2021-09-30 15:00:00,1087,540,547,Leicht bewölkt,15,16,0,
,2021-09-30 16:00:00,1020,535,485,Leicht bewölkt,13,13,0,
,2021-09-30 17:00:00,1146,491,655,Leicht bewölkt,11,11,0,
,2021-09-30 18:00:00,983,450,533,Leicht bewölkt,9,8,0,
,2021-09-30 19:00:00,678,323,355,Leicht bewölkt,8,7,0,
,2021-09-30 20:00:00,425,172,253,Leicht bewölkt,7,6,0,
,2021-09-30 21:00:00,264,119,145,Leicht bewölkt,6,5,0,
,2021-09-30 22:00:00,209,90,119,Leicht bewölkt,5,5,0,
,2021-09-30 23:00:00,158,50,108,Leicht bewölkt,5,5,0,
,2021-10-01 00:00:00,90,37,53,Leicht bewölkt,5,5,0,
,2021-10-01 01:00:00,46,8,38,Leicht bewölkt,5,5,0,
,2021-10-01 02:00:00,14,5,9,Leicht bewölkt,4,4,0,
,2021-10-01 03:00:00,6,4,2,Leicht bewölkt,4,4,0,
,2021-10-01 04:00:00,7,3,4,Leicht bewölkt,4,4,0,
,2021-10-01 05:00:00,37,25,12,Leicht bewölkt,4,4,0,
,2021-10-01 06:00:00,162,100,62,Leicht bewölkt,4,4,0,
,2021-10-01 07:00:00,951,586,365,Leicht bewölkt,7,7,0,
,2021-10-01 08:00:00,789,462,327,Leicht bewölkt,9,9,0,
,2021-10-01 09:00:00,621,380,241,Leicht bewölkt,11,11,0,
,2021-10-01 10:00:00,542,300,242,Leicht bewölkt,14,14,0,
,2021-10-01 11:00:00,708,343,365,Leicht bewölkt,16,16,0,
,2021-10-01 12:00:00,856,388,468,Leicht bewölkt,19,19,0,
,2021-10-01 13:00:00,1058,418,640,Leicht bewölkt,19,19,0,
,2021-10-01 14:00:00,850,434,416,Sonnig,20,20,0,
,2021-10-01 15:00:00,893,451,442,Sonnig,21,21,0,
,2021-10-01 16:00:00,873,430,443,Sonnig,18,18,0,
,2021-10-01 17:00:00,820,384,436,Leicht bewölkt,15,15,0,
,2021-10-01 18:00:00,811,391,420,Leicht bewölkt,12,13,0,
,2021-10-01 19:00:00,644,303,341,Leicht bewölkt,12,12,0,
,2021-10-01 20:00:00,449,222,227,Leicht bewölkt,11,11,0,
,2021-10-01 21:00:00,330,186,144,Leicht bewölkt,10,10,0,
,2021-10-01 22:00:00,223,114,109,Leicht bewölkt,10,10,0,
,2021-10-01 23:00:00,212,81,131,Leicht bewölkt,10,11,0,
,2021-10-02 00:00:00,167,61,106,Leicht bewölkt,11,11,0,
,2021-10-02 01:00:00,138,45,93,Leicht bewölkt,11,11,0,
,2021-10-02 02:00:00,76,22,54,Bedeckt,11,11,0,
,2021-10-02 03:00:00,58,16,42,Bedeckt,11,12,0,
,2021-10-02 04:00:00,32,16,16,Bedeckt,11,11,0,
,2021-10-02 05:00:00,38,22,16,Leicht bewölkt,10,10,0,
,2021-10-02 06:00:00,41,26,15,Leicht bewölkt,10,10,0,
,2021-10-02 07:00:00,67,39,28,Leicht bewölkt,12,12,0,
,2021-10-02 08:00:00,164,90,74,Leicht bewölkt,14,14,0,
,2021-10-02 09:00:00,365,207,158,Leicht bewölkt,16,16,0,
,2021-10-02 10:00:00,455,243,212,Leicht bewölkt,17,17,0,
,2021-10-02 11:00:00,614,338,276,Leicht bewölkt,19,19,0,
,2021-10-02 12:00:00,675,357,318,Leicht bewölkt,20,20,0,
,2021-10-02 13:00:00,631,302,329,Leicht bewölkt,21,21,0,
,2021-10-02 14:00:00,704,365,339,Leicht bewölkt,21,21,0,
,2021-10-02 15:00:00,728,359,369,Leicht bewölkt,22,22,0,
,2021-10-02 16:00:00,683,302,381,Leicht bewölkt,20,20,0,
,2021-10-02 17:00:00,638,278,360,Leicht bewölkt,17,17,0,
,2021-10-02 18:00:00,649,327,322,Leicht bewölkt,15,15,0,
,2021-10-02 19:00:00,524,283,241,Leicht bewölkt,14,14,0,
,2021-10-02 20:00:00,341,174,167,Leicht bewölkt,13,13,0,
,2021-10-02 21:00:00,286,129,157,Leicht bewölkt,12,12,0,
,2021-10-02 22:00:00,209,82,127,Leicht bewölkt,11,11,0,
,2021-10-02 23:00:00,176,68,108,Leicht bewölkt,10,10,0,
,2021-10-03 00:00:00,120,41,79,Leicht bewölkt,10,9,0,
,2021-10-03 01:00:00,90,36,54,Leicht bewölkt,10,9,0,
,2021-10-03 02:00:00,92,21,71,Leicht bewölkt,10,9,0,
,2021-10-03 03:00:00,66,12,54,Leicht bewölkt,10,9,0,
,2021-10-03 04:00:00,39,15,24,Leicht bewölkt,9,8,0,
,2021-10-03 05:00:00,19,13,6,Leicht bewölkt,9,8,0,
,2021-10-03 06:00:00,35,21,14,Leicht bewölkt,9,8,0,
,2021-10-03 07:00:00,61,26,35,Leicht bewölkt,11,10,0,
,2021-10-03 08:00:00,107,61,46,Leicht bewölkt,13,13,0,
,2021-10-03 09:00:00,185,86,99,Leicht bewölkt,15,15,0,
,2021-10-03 10:00:00,279,161,118,Leicht bewölkt,17,17,0,
,2021-10-03 11:00:00,407,227,180,Leicht bewölkt,19,19,0,
,2021-10-03 12:00:00,432,246,186,Leicht bewölkt,21,21,0,
,2021-10-03 13:00:00,471,301,170,Leicht bewölkt,21,21,0,
,2021-10-03 14:00:00,582,318,264,Leicht bewölkt,21,21,0,
,2021-10-03 15:00:00,596,284,312,Leicht bewölkt,21,21,0,
,2021-10-03 16:00:00,598,266,332,Leicht bewölkt,19,19,0,
,2021-10-03 17:00:00,592,225,367,Leicht bewölkt,17,17,0,
,2021-10-03 18:00:00,440,171,269,Leicht bewölkt,15,15,0,
,2021-10-03 19:00:00,296,120,176,Leicht bewölkt,14,14,0,
,2021-10-03 20:00:00,201,94,107,Leicht bewölkt,13,13,0,
,2021-10-03 21:00:00,121,51,70,Leicht bewölkt,12,12,0,
,2021-10-03 22:00:00,90,30,60,Leicht bewölkt,11,12,0,
,2021-10-03 23:00:00,52,17,35,Bedeckt,11,11,0,
,2021-10-04 00:00:00,35,21,14,Bedeckt,11,11,0,
,2021-10-04 01:00:00,22,16,6,Bedeckt,11,12,0,
,2021-10-04 02:00:00,9,3,6,Bedeckt,12,13,0,
,2021-10-04 03:00:00,3,0,3,Bedeckt,13,14,0,
,2021-10-04 04:00:00,11,8,3,Bedeckt,13,13,0,
,2021-10-04 05:00:00,39,23,16,Stellenweiser Regenfall,12,13,0,
,2021-10-04 06:00:00,173,109,64,Stellenweiser Regenfall,12,12,0,
,2021-10-04 07:00:00,908,584,324,Stellenweiser Regenfall,12,11,0,
,2021-10-04 08:00:00,527,300,227,Stellenweiser Regenfall,11,10,0,
,2021-10-04 09:00:00,495,295,200,Stellenweiser Regenfall,11,9,0,
,2021-10-04 10:00:00,310,179,131,Stellenweiser Regenfall,11,9,0,
,2021-10-04 11:00:00,405,214,191,Stellenweiser Regenfall,11,10,0,
,2021-10-04 12:00:00,446,214,232,Stellenweiser Regenfall,11,10,0,
,2021-10-04 13:00:00,763,320,443,Stellenweiser Regenfall,11,10,0,
,2021-10-04 14:00:00,501,261,240,Bedeckt,11,10,0,
,2021-10-04 15:00:00,832,423,409,Bedeckt,11,10,0,
,2021-10-04 16:00:00,764,386,378,Bedeckt,11,10,0,
,2021-10-04 17:00:00,922,376,546,Bedeckt,11,10,0,
,2021-10-04 18:00:00,730,354,376,Bedeckt,11,10,0,
,2021-10-04 19:00:00,530,245,285,Bedeckt,11,10,0,
,2021-10-04 20:00:00,346,173,173,Bedeckt,11,10,0,
,2021-10-04 21:00:00,202,81,121,Bedeckt,11,10,0,
,2021-10-04 22:00:00,185,79,106,Bedeckt,11,10,0,
,2021-10-04 23:00:00,77,32,45,Bedeckt,11,10,0,
,2021-10-05 00:00:00,48,19,29,Bedeckt,10,10,0,
,2021-10-05 01:00:00,27,8,19,Bedeckt,10,10,0,
,2021-10-05 02:00:00,14,9,5,Bedeckt,10,10,0,
,2021-10-05 03:00:00,17,8,9,Bedeckt,10,9,0,
,2021-10-05 04:00:00,17,10,7,Bedeckt,10,9,0,
,2021-10-05 05:00:00,36,25,11,Leichter Nebel,10,9,0,
,2021-10-05 06:00:00,157,101,56,Leichter Nebel,9,9,0,
,2021-10-05 07:00:00,945,652,293,Leichter Nebel,11,10,0,
,2021-10-05 08:00:00,676,370,306,Bewölkt,12,12,0,
,2021-10-05 09:00:00,625,376,249,Bewölkt,13,13,0,
,2021-10-05 10:00:00,391,225,166,Bewölkt,13,13,0,
,2021-10-05 11:00:00,566,302,264,Bewölkt,13,13,0,
,2021-10-05 12:00:00,545,234,311,Bewölkt,13,13,0,
,2021-10-05 13:00:00,868,406,462,Bewölkt,13,13,0,
,2021-10-05 14:00:00,489,222,267,Stellenweiser Nieselregen,13,12,0.1,
,2021-10-05 15:00:00,767,346,421,Stellenweiser Nieselregen,13,12,0.1,
,2021-10-05 16:00:00,762,357,405,Stellenweiser Nieselregen,12,12,0,
,2021-10-05 17:00:00,961,431,530,Nieselregen,12,11,0.2,
,2021-10-05 18:00:00,845,412,433,Nieselregen,11,10,0.3,
,2021-10-05 19:00:00,585,275,310,Nieselregen,11,11,0.2,
,2021-10-05 20:00:00,384,156,228,Leichter Nebel,11,11,0,
,2021-10-05 21:00:00,248,104,144,Leichter Nebel,11,11,0,
,2021-10-05 22:00:00,181,76,105,Leichter Nebel,11,10,0,
,2021-10-05 23:00:00,91,27,64,Leichter Regenfall,11,9,0.3,
,2021-10-06 00:00:00,52,18,34,Leichter Regenfall,10,8,0.5,
,2021-10-06 01:00:00,40,14,26,Leichter Regenfall,10,8,0.3,
,2021-10-06 02:00:00,11,2,9,Leichter Regenschauer,9,7,0.1,
,2021-10-06 03:00:00,5,3,2,Leichter Regenschauer,9,7,0.1,
,2021-10-06 04:00:00,8,5,3,Leichter Regenschauer,8,6,0,
,2021-10-06 05:00:00,59,43,16,Stellenweiser Regenfall,8,6,0.1,
,2021-10-06 06:00:00,163,99,64,Stellenweiser Regenfall,8,6,0.1,
,2021-10-06 07:00:00,1156,817,339,Stellenweiser Regenfall,8,6,0,
,2021-10-06 08:00:00,795,463,332,Leichter Regenschauer,9,7,0.1,
,2021-10-06 09:00:00,704,441,263,Leichter Regenschauer,9,7,0.1,
,2021-10-06 10:00:00,452,238,214,Leichter Regenschauer,10,8,0,
,2021-10-06 11:00:00,714,312,402,Leichter Regenschauer,10,8,0.1,
,2021-10-06 12:00:00,729,363,366,Leichter Regenschauer,11,9,0.1,
,2021-10-06 13:00:00,1128,610,518,Leichter Regenschauer,11,9,0,
,2021-10-06 14:00:00,733,373,360,Stellenweiser Regenfall,11,9,0,
,2021-10-06 15:00:00,1084,458,626,Stellenweiser Regenfall,12,10,0,
,2021-10-06 16:00:00,851,384,467,Stellenweiser Regenfall,10,8,0,
,2021-10-06 17:00:00,1019,451,568,Stellenweiser Regenfall,8,7,0,
,2021-10-06 18:00:00,747,320,427,Stellenweiser Regenfall,7,5,0,
,2021-10-06 19:00:00,479,206,273,Stellenweiser Regenfall,6,5,0,
,2021-10-06 20:00:00,375,184,191,Leicht bewölkt,6,5,0,
,2021-10-06 21:00:00,203,86,117,Leicht bewölkt,5,4,0,
,2021-10-06 22:00:00,173,72,101,Leicht bewölkt,5,5,0,
,2021-10-06 23:00:00,92,31,61,Leicht bewölkt,6,5,0,
,2021-10-07 00:00:00,90,25,65,Leicht bewölkt,6,5,0,
,2021-10-07 01:00:00,43,20,23,Leicht bewölkt,6,5,0,
,2021-10-07 02:00:00,19,8,11,Leicht bewölkt,6,5,0,
,2021-10-07 03:00:00,9,5,4,Leicht bewölkt,6,6,0,
,2021-10-07 04:00:00,15,11,4,Leicht bewölkt,6,6,0,
,2021-10-07 05:00:00,42,31,11,Bedeckt,5,5,0,
,2021-10-07 06:00:00,158,99,59,Bedeckt,5,5,0,
,2021-10-07 07:00:00,1062,727,335,Bedeckt,6,7,0,
,2021-10-07 08:00:00,739,399,340,Leicht bewölkt,8,8,0,
,2021-10-07 09:00:00,713,419,294,Leicht bewölkt,9,9,0,
,2021-10-07 10:00:00,452,263,189,Leicht bewölkt,10,10,0,
,2021-10-07 11:00:00,694,351,343,Bewölkt,11,10,0,
,2021-10-07 12:00:00,648,289,359,Bewölkt,12,11,0,
,2021-10-07 13:00:00,911,413,498,Bewölkt,12,11,0,
,2021-10-07 14:00:00,681,353,328,Bewölkt,13,11,0,
,2021-10-07 15:00:00,1019,484,535,Bewölkt,13,12,0,
,2021-10-07 16:00:00,921,425,496,Bewölkt,12,10,0,
,2021-10-07 17:00:00,1078,472,606,Bewölkt,11,9,0,
,2021-10-07 18:00:00,919,459,460,Bewölkt,10,7,0,
,2021-10-07 19:00:00,653,290,363,Bewölkt,9,7,0,
,2021-10-07 20:00:00,390,183,207,Bedeckt,9,7,0,
,2021-10-07 21:00:00,244,119,125,Bedeckt,9,6,0,
,2021-10-07 22:00:00,229,75,154,Bedeckt,8,6,0,
,2021-10-07 23:00:00,138,44,94,Bewölkt,7,5,0,
,2021-10-08 00:00:00,81,24,57,Bewölkt,7,4,0,
,2021-10-08 01:00:00,49,14,35,Bewölkt,7,4,0,
,2021-10-08 02:00:00,23,10,13,Bewölkt,7,4,0,
,2021-10-08 03:00:00,18,11,7,Bewölkt,7,4,0,
,2021-10-08 04:00:00,15,13,2,Bewölkt,6,4,0,
,2021-10-08 05:00:00,40,24,16,Bewölkt,6,4,0,
,2021-10-08 06:00:00,151,89,62,Bewölkt,6,4,0,
,2021-10-08 07:00:00,961,611,350,Bewölkt,7,5,0,
,2021-10-08 08:00:00,679,369,310,Bedeckt,8,7,0,
,2021-10-08 09:00:00,665,439,226,Bedeckt,10,8,0,
,2021-10-08 10:00:00,532,280,252,Bedeckt,11,9,0,
,2021-10-08 11:00:00,910,453,457,Leicht bewölkt,12,11,0,
,2021-10-08 12:00:00,788,314,474,Leicht bewölkt,14,12,0,
,2021-10-08 13:00:00,944,373,571,Leicht bewölkt,14,12,0,
,2021-10-08 14:00:00,739,360,379,Bedeckt,14,12,0,
,2021-10-08 15:00:00,842,412,430,Bedeckt,14,13,0,
,2021-10-08 16:00:00,842,438,404,Bedeckt,13,11,0,
,2021-10-08 17:00:00,868,443,425,Leicht bewölkt,11,9,0,
,2021-10-08 18:00:00,741,358,383,Leicht bewölkt,10,8,0,
,2021-10-08 19:00:00,550,312,238,Leicht bewölkt,10,7,0,
,2021-10-08 20:00:00,393,220,173,Leicht bewölkt,9,7,0,
,2021-10-08 21:00:00,289,146,143,Leicht bewölkt,9,6,0,
,2021-10-08 22:00:00,196,77,119,Leicht bewölkt,8,5,0,
,2021-10-08 23:00:00,174,60,114,Leicht bewölkt,7,4,0,
,2021-10-09 00:00:00,138,47,91,Leicht bewölkt,6,4,0,
,2021-10-09 01:00:00,105,30,75,Leicht bewölkt,5,3,0,
,2021-10-09 02:00:00,125,16,109,Leicht bewölkt,5,3,0,
,2021-10-09 03:00:00,62,10,52,Leicht bewölkt,4,2,0,
,2021-10-09 04:00:00,30,10,20,Leicht bewölkt,4,2,0,
,2021-10-09 05:00:00,31,14,17,Leichter Nebel,4,2,0,
,2021-10-09 06:00:00,48,29,19,Leichter Nebel,3,1,0,
,2021-10-09 07:00:00,62,29,33,Leichter Nebel,5,3,0,
,2021-10-09 08:00:00,191,116,75,Leicht bewölkt,7,5,0,
,2021-10-09 09:00:00,346,229,117,Leicht bewölkt,8,6,0,
,2021-10-09 10:00:00,449,238,211,Leicht bewölkt,11,9,0,
,2021-10-09 11:00:00,590,314,276,Sonnig,13,12,0,
,2021-10-09 12:00:00,619,330,289,Sonnig,16,16,0,
,2021-10-09 13:00:00,630,313,317,Sonnig,16,16,0,
,2021-10-09 14:00:00,607,318,289,Sonnig,16,16,0,
,2021-10-09 15:00:00,646,345,301,Sonnig,17,17,0,
,2021-10-09 16:00:00,680,329,351,Sonnig,15,15,0,
,2021-10-09 17:00:00,632,286,346,Sonnig,14,12,0,
,2021-10-09 18:00:00,566,247,319,Sonnig,12,10,0,
,2021-10-09 19:00:00,440,219,221,Sonnig,10,8,0,
,2021-10-09 20:00:00,318,194,124,Sonnig,8,6,0,
,2021-10-09 21:00:00,251,143,108,Sonnig,6,3,0,
,2021-10-09 22:00:00,199,101,98,Sonnig,5,3,0,
,2021-10-09 23:00:00,170,71,99,Sonnig,4,2,0,
,2021-10-10 00:00:00,122,46,76,Sonnig,3,2,0,
,2021-10-10 01:00:00,136,38,98,Sonnig,2,1,0,
,2021-10-10 02:00:00,85,24,61,Leichter Nebel,2,0,0,
,2021-10-10 03:00:00,86,17,69,Leichter Nebel,1,-1,0,
,2021-10-10 04:00:00,36,10,26,Leichter Nebel,1,-1,0,
,2021-10-10 05:00:00,25,17,8,Leichter Nebel,1,-1,0,
,2021-10-10 06:00:00,23,16,7,Leichter Nebel,1,-1,0,
,2021-10-10 07:00:00,50,19,31,Leichter Nebel,2,1,0,
,2021-10-10 08:00:00,71,40,31,Leicht bewölkt,4,3,0,
,2021-10-10 09:00:00,164,84,80,Leicht bewölkt,6,5,0,
,2021-10-10 10:00:00,219,119,100,Leicht bewölkt,8,7,0,
,2021-10-10 11:00:00,277,131,146,Leicht bewölkt,9,9,0,
,2021-10-10 12:00:00,280,136,144,Leicht bewölkt,11,11,0,
,2021-10-10 13:00:00,300,144,156,Leicht bewölkt,12,11,0,
,2021-10-10 14:00:00,356,190,166,Leicht bewölkt,12,11,0,
,2021-10-10 15:00:00,379,191,188,Leicht bewölkt,12,11,0,
,2021-10-10 16:00:00,456,222,234,Leicht bewölkt,10,9,0,
,2021-10-10 17:00:00,470,265,205,Leicht bewölkt,8,6,0,
,2021-10-10 18:00:00,384,170,214,Leicht bewölkt,5,3,0,
,2021-10-10 19:00:00,239,127,112,Leicht bewölkt,5,3,0,
,2021-10-10 20:00:00,191,90,101,Leicht bewölkt,4,2,0,
,2021-10-10 21:00:00,129,58,71,Leicht bewölkt,3,1,0,
,2021-10-10 22:00:00,97,34,63,Leicht bewölkt,2,1,0,
,2021-10-10 23:00:00,63,16,47,Leicht bewölkt,2,1,0,
,2021-10-11 00:00:00,16,5,11,Leicht bewölkt,1,1,0,
,2021-10-11 01:00:00,14,7,7,Leicht bewölkt,1,1,0,
,2021-10-11 02:00:00,4,0,4,Sonnig,0,0,0,
,2021-10-11 03:00:00,2,0,2,Sonnig,0,0,0,
,2021-10-11 04:00:00,13,7,6,Sonnig,0,0,0,
,2021-10-11 05:00:00,35,19,16,Leicht bewölkt,0,0,0,
,2021-10-11 06:00:00,168,100,68,Leicht bewölkt,0,0,0,
,2021-10-11 07:00:00,1024,666,358,Leicht bewölkt,2,2,0,
,2021-10-11 08:00:00,712,379,333,Leicht bewölkt,4,4,0,
,2021-10-11 09:00:00,695,443,252,Leicht bewölkt,6,6,0,
,2021-10-11 10:00:00,429,243,186,Leicht bewölkt,8,8,0,
,2021-10-11 11:00:00,698,315,383,Leicht bewölkt,10,10,0,
,2021-10-11 12:00:00,586,255,331,Leicht bewölkt,12,12,0,
,2021-10-11 13:00:00,1063,454,609,Leicht bewölkt,12,13,0,
,2021-10-11 14:00:00,671,351,320,Leicht bewölkt,13,13,0,
,2021-10-11 15:00:00,1043,470,573,Leicht bewölkt,13,13,0,
,2021-10-11 16:00:00,928,466,462,Leicht bewölkt,11,11,0,
,2021-10-11 17:00:00,1071,467,604,Leicht bewölkt,9,9,0,
,2021-10-11 18:00:00,793,365,428,Leicht bewölkt,7,7,0,
,2021-10-11 19:00:00,548,220,328,Leicht bewölkt,6,6,0,
,2021-10-11 20:00:00,385,183,202,Leicht bewölkt,5,5,0,
,2021-10-11 21:00:00,209,99,110,Leicht bewölkt,5,5,0,
,2021-10-11 22:00:00,156,60,96,Leicht bewölkt,5,5,0,
,2021-10-11 23:00:00,97,37,60,Leicht bewölkt,5,5,0,
,2021-10-12 00:00:00,27,9,18,Leicht bewölkt,5,5,0,
,2021-10-12 01:00:00,35,9,26,Leicht bewölkt,5,5,0,
,2021-10-12 02:00:00,13,9,4,Bedeckt,5,5,0,
,2021-10-12 03:00:00,11,11,0,Bedeckt,4,4,0,
,2021-10-12 04:00:00,20,14,6,Bedeckt,5,5,0,
,2021-10-12 05:00:00,49,35,14,Bedeckt,5,5,0,
,2021-10-12 06:00:00,186,106,80,Bedeckt,5,5,0,
,2021-10-12 07:00:00,1113,783,330,Bedeckt,6,6,0,
,2021-10-12 08:00:00,788,441,347,Leicht bewölkt,7,7,0,
,2021-10-12 09:00:00,739,463,276,Leicht bewölkt,8,8,0,
,2021-10-12 10:00:00,447,270,177,Leicht bewölkt,9,9,0,
,2021-10-12 11:00:00,642,299,343,Stellenweiser Regenfall,10,9,0,
,2021-10-12 12:00:00,661,270,391,Stellenweiser Regenfall,10,10,0,
,2021-10-12 13:00:00,950,440,510,Stellenweiser Regenfall,9,9,0,
,2021-10-12 14:00:00,557,269,288,Stellenweiser Nieselregen,9,8,0.2,
,2021-10-12 15:00:00,1005,466,539,Stellenweiser Nieselregen,8,7,0.3,
,2021-10-12 16:00:00,894,390,504,Stellenweiser Nieselregen,7,6,0.2,
,2021-10-12 17:00:00,986,423,563,Leichter Regenschauer,7,6,0.1,
,2021-10-12 18:00:00,797,349,448,Leichter Regenschauer,6,6,0.2,
,2021-10-12 19:00:00,609,277,332,Leichter Regenschauer,6,5,0.1,
,2021-10-12 20:00:00,411,194,217,Bedeckt,5,5,0,
,2021-10-12 21:00:00,227,89,138,Bedeckt,5,5,0,
,2021-10-12 22:00:00,176,58,118,Bedeckt,4,4,0,
,2021-10-12 23:00:00,119,39,80,Stellenweiser Regenfall,3,3,0.1,
,2021-10-13 00:00:00,49,10,39,Stellenweiser Regenfall,3,3,0.1,
,2021-10-13 01:00:00,22,6,16,Stellenweiser Regenfall,3,3,0.1,
,2021-10-13 02:00:00,15,4,11,Stellenweiser Regenfall,3,3,0,
,2021-10-13 03:00:00,11,3,8,Stellenweiser Regenfall,4,4,0,
,2021-10-13 04:00:00,11,10,1,Stellenweiser Regenfall,4,4,0,
,2021-10-13 05:00:00,58,37,21,Stellenweiser Regenfall,4,3,0,
,2021-10-13 06:00:00,189,114,75,Stellenweiser Regenfall,4,3,0,
,2021-10-13 07:00:00,1154,776,378,Stellenweiser Regenfall,5,4,0,
,2021-10-13 08:00:00,764,448,316,Leicht bewölkt,6,6,0,
,2021-10-13 09:00:00,658,382,276,Leicht bewölkt,7,7,0,
,2021-10-13 10:00:00,415,251,164,Leicht bewölkt,8,8,0,
,2021-10-13 11:00:00,637,238,399,Stellenweiser Regenfall,9,9,0,
,2021-10-13 12:00:00,744,341,403,Stellenweiser Regenfall,11,10,0,
,2021-10-13 13:00:00,1074,571,503,Stellenweiser Regenfall,11,10,0,
,2021-10-13 14:00:00,675,352,323,Bewölkt,11,10,0,
,2021-10-13 15:00:00,1100,475,625,Bewölkt,11,10,0,
,2021-10-13 16:00:00,900,430,470,Bewölkt,9,8,0,
,2021-10-13 17:00:00,1082,472,610,Leicht bewölkt,7,6,0,
,2021-10-13 18:00:00,916,382,534,Leicht bewölkt,6,4,0,
,2021-10-13 19:00:00,544,263,281,Leicht bewölkt,5,4,0,
,2021-10-13 20:00:00,427,223,204,Stellenweiser Regenfall,4,3,0,
,2021-10-13 21:00:00,246,94,152,Stellenweiser Regenfall,3,2,0,
,2021-10-13 22:00:00,212,76,136,Stellenweiser Regenfall,2,2,0,
,2021-10-13 23:00:00,126,40,86,Sonnig,2,2,0,
,2021-10-14 00:00:00,56,17,39,Sonnig,2,2,0,
,2021-10-14 01:00:00,49,14,35,Sonnig,2,2,0,
,2021-10-14 02:00:00,14,6,8,Sonnig,2,2,0,
,2021-10-14 03:00:00,2,1,1,Sonnig,1,1,0,
,2021-10-14 04:00:00,10,8,2,Sonnig,1,1,0,
,2021-10-14 05:00:00,47,31,16,Sonnig,1,1,0,
,2021-10-14 06:00:00,157,91,66,Sonnig,1,1,0,
,2021-10-14 07:00:00,1051,737,314,Sonnig,2,2,0,
,2021-10-14 08:00:00,847,485,362,Sonnig,4,4,0,
,2021-10-14 09:00:00,750,428,322,Sonnig,6,6,0,
,2021-10-14 10:00:00,449,251,198,Sonnig,8,8,0,
,2021-10-14 11:00:00,629,288,341,Sonnig,10,10,0,
,2021-10-14 12:00:00,673,310,363,Sonnig,12,12,0,
,2021-10-14 13:00:00,1036,448,588,Sonnig,12,12,0,
,2021-10-14 14:00:00,737,364,373,Sonnig,12,12,0,
,2021-10-14 15:00:00,1121,527,594,Sonnig,13,13,0,
,2021-10-14 16:00:00,908,434,474,Sonnig,11,10,0,
,2021-10-14 17:00:00,1149,478,671,Sonnig,9,8,0,
,2021-10-14 18:00:00,917,407,510,Sonnig,7,6,0,
,2021-10-14 19:00:00,609,292,317,Sonnig,6,5,0,
,2021-10-14 20:00:00,427,211,216,Sonnig,5,4,0,
,2021-10-14 21:00:00,265,114,151,Sonnig,3,3,0,
,2021-10-14 22:00:00,252,92,160,Sonnig,3,3,0,
,2021-10-14 23:00:00,148,48,100,Sonnig,3,3,0,
,2021-10-15 00:00:00,101,26,75,Sonnig,2,2,0,
,2021-10-15 01:00:00,68,12,56,Sonnig,2,2,0,
,2021-10-15 02:00:00,32,11,21,Sonnig,2,2,0,
,2021-10-15 03:00:00,19,8,11,Sonnig,1,1,0,
,2021-10-15 04:00:00,12,10,2,Sonnig,1,1,0,
,2021-10-15 05:00:00,46,36,10,Sonnig,1,1,0,
,2021-10-15 06:00:00,153,96,57,Sonnig,1,1,0,
,2021-10-15 07:00:00,925,598,327,Sonnig,3,3,0,
,2021-10-15 08:00:00,651,375,276,Sonnig,5,5,0,
,2021-10-15 09:00:00,720,457,263,Sonnig,7,7,0,
,2021-10-15 10:00:00,500,311,189,Sonnig,9,9,0,
,2021-10-15 11:00:00,713,330,383,Sonnig,11,11,0,
,2021-10-15 12:00:00,830,396,434,Sonnig,13,13,0,
,2021-10-15 13:00:00,1152,471,681,Sonnig,13,13,0,
,2021-10-15 14:00:00,772,405,367,Sonnig,13,14,0,
,2021-10-15 15:00:00,849,404,445,Sonnig,14,15,0,
,2021-10-15 16:00:00,897,457,440,Sonnig,12,12,0,
,2021-10-15 17:00:00,760,373,387,Leicht bewölkt,10,10,0,
,2021-10-15 18:00:00,700,313,387,Leicht bewölkt,8,8,0,
,2021-10-15 19:00:00,526,272,254,Leicht bewölkt,7,7,0,
,2021-10-15 20:00:00,368,187,181,Leicht bewölkt,6,6,0,
,2021-10-15 21:00:00,257,130,127,Leicht bewölkt,6,6,0,
,2021-10-15 22:00:00,217,84,133,Leicht bewölkt,6,6,0,
,2021-10-15 23:00:00,221,77,144,Leicht bewölkt,5,5,0,
,2021-10-16 00:00:00,146,37,109,Leicht bewölkt,5,5,0,
,2021-10-16 01:00:00,82,26,56,Leicht bewölkt,4,4,0,
,2021-10-16 02:00:00,73,26,47,Leicht bewölkt,4,4,0,
,2021-10-16 03:00:00,58,10,48,Leicht bewölkt,3,3,0,
,2021-10-16 04:00:00,21,9,12,Leicht bewölkt,4,3,0,
,2021-10-16 05:00:00,35,19,16,Leicht bewölkt,4,3,0,
,2021-10-16 06:00:00,46,29,17,Leicht bewölkt,4,4,0,
,2021-10-16 07:00:00,90,53,37,Leicht bewölkt,5,5,0,
,2021-10-16 08:00:00,174,93,81,Sonnig,7,7,0,
,2021-10-16 09:00:00,346,215,131,Sonnig,8,9,0,
,2021-10-16 10:00:00,415,217,198,Sonnig,10,10,0,
,2021-10-16 11:00:00,473,230,243,Leicht bewölkt,11,11,0,
,2021-10-16 12:00:00,636,352,284,Leicht bewölkt,13,13,0,
,2021-10-16 13:00:00,544,256,288,Leicht bewölkt,13,13,0,
,2021-10-16 14:00:00,612,331,281,Leicht bewölkt,14,13,0,
,2021-10-16 15:00:00,577,277,300,Leicht bewölkt,14,14,0,
,2021-10-16 16:00:00,538,259,279,Leicht bewölkt,12,12,0,
,2021-10-16 17:00:00,664,307,357,Leicht bewölkt,11,10,0,
,2021-10-16 18:00:00,567,265,302,Leicht bewölkt,10,9,0,
,2021-10-16 19:00:00,409,197,212,Leicht bewölkt,9,8,0,
,2021-10-16 20:00:00,326,148,178,Leicht bewölkt,8,7,0,
,2021-10-16 21:00:00,238,103,135,Leicht bewölkt,7,6,0,
,2021-10-16 22:00:00,196,84,112,Leicht bewölkt,6,5,0,
,2021-10-16 23:00:00,132,35,97,Sonnig,4,4,0,
,2021-10-17 00:00:00,142,54,88,Sonnig,3,3,0,
,2021-10-17 01:00:00,78,28,50,Sonnig,3,3,0,
,2021-10-17 02:00:00,83,33,50,Leichter Nebel,3,3,0,
,2021-10-17 03:00:00,48,15,33,Leichter Nebel,2,2,0,
,2021-10-17 04:00:00,33,15,18,Leichter Nebel,2,2,0,
,2021-10-17 05:00:00,27,19,8,Leichter Nebel,2,2,0,
,2021-10-17 06:00:00,31,19,12,Leichter Nebel,2,2,0,
,2021-10-17 07:00:00,43,18,25,Leichter Nebel,4,4,0,
,2021-10-17 08:00:00,62,36,26,Leicht bewölkt,6,6,0,
,2021-10-17 09:00:00,126,56,70,Leicht bewölkt,8,8,0,
,2021-10-17 10:00:00,181,94,87,Leicht bewölkt,9,9,0,
,2021-10-17 11:00:00,276,164,112,Sonnig,11,11,0,
,2021-10-17 12:00:00,303,144,159,Sonnig,13,13,0,
,2021-10-17 13:00:00,338,155,183,Sonnig,14,14,0,
,2021-10-17 14:00:00,373,184,189,Sonnig,15,15,0,
,2021-10-17 15:00:00,345,159,186,Sonnig,16,16,0,
,2021-10-17 16:00:00,362,157,205,Sonnig,13,14,0,
,2021-10-17 17:00:00,423,212,211,Sonnig,11,11,0,
,2021-10-17 18:00:00,357,177,180,Sonnig,8,8,0,
,2021-10-17 19:00:00,218,121,97,Sonnig,7,7,0,
,2021-10-17 20:00:00,159,72,87,Bedeckt,7,6,0,
,2021-10-17 21:00:00,127,66,61,Bedeckt,6,6,0,
,2021-10-17 22:00:00,81,31,50,Bedeckt,6,6,0,
,2021-10-17 23:00:00,65,19,46,Bedeckt,6,5,0,
,2021-10-18 00:00:00,34,14,20,Bedeckt,5,5,0,
,2021-10-18 01:00:00,13,7,6,Bedeckt,6,6,0,
,2021-10-18 02:00:00,7,4,3,Bedeckt,6,6,0,
,2021-10-18 03:00:00,4,2,2,Bedeckt,6,6,0,
,2021-10-18 04:00:00,7,5,2,Bedeckt,6,6,0,
,2021-10-18 05:00:00,48,31,17,Leicht bewölkt,6,6,0,
,2021-10-18 06:00:00,185,108,77,Leicht bewölkt,6,6,0,
,2021-10-18 07:00:00,1033,677,356,Leicht bewölkt,7,7,0,
,2021-10-18 08:00:00,752,427,325,Sonnig,9,9,0,
,2021-10-18 09:00:00,645,378,267,Sonnig,10,10,0,
,2021-10-18 10:00:00,423,242,181,Sonnig,12,12,0,
,2021-10-18 11:00:00,652,316,336,Sonnig,14,14,0,
,2021-10-18 12:00:00,620,288,332,Sonnig,16,16,0,
,2021-10-18 13:00:00,1093,478,615,Sonnig,16,16,0,
,2021-10-18 14:00:00,676,353,323,Sonnig,16,16,0,
,2021-10-18 15:00:00,1056,520,536,Sonnig,17,17,0,
,2021-10-18 16:00:00,896,456,440,Sonnig,15,15,0,
,2021-10-18 17:00:00,1075,439,636,Sonnig,13,13,0,
,2021-10-18 18:00:00,884,394,490,Sonnig,11,11,0,
,2021-10-18 19:00:00,573,258,315,Sonnig,10,10,0,
,2021-10-18 20:00:00,377,145,232,Sonnig,8,8,0,
,2021-10-18 21:00:00,222,96,126,Sonnig,7,7,0,
,2021-10-18 22:00:00,169,74,95,Sonnig,7,7,0,
,2021-10-18 23:00:00,79,32,47,Bedeckt,7,7,0,
,2021-10-19 00:00:00,35,15,20,Bedeckt,6,6,0,
,2021-10-19 01:00:00,23,11,12,Bedeckt,6,6,0,
,2021-10-19 02:00:00,22,10,12,Bedeckt,7,7,0,
,2021-10-19 03:00:00,11,9,2,Bedeckt,7,7,0,
,2021-10-19 04:00:00,15,10,5,Bedeckt,7,7,0,
,2021-10-19 05:00:00,49,32,17,Leicht bewölkt,6,6,0,
,2021-10-19 06:00:00,202,119,83,Leicht bewölkt,6,6,0,
,2021-10-19 07:00:00,1102,749,353,Leicht bewölkt,8,8,0,
,2021-10-19 08:00:00,817,475,342,Leicht bewölkt,10,10,0,
,2021-10-19 09:00:00,735,446,289,Leicht bewölkt,11,12,0,
,2021-10-19 10:00:00,473,274,199,Leicht bewölkt,12,12,0,
,2021-10-19 11:00:00,655,325,330,Bewölkt,12,12,0,
,2021-10-19 12:00:00,643,306,337,Bewölkt,12,13,0,
,2021-10-19 13:00:00,1057,460,597,Bewölkt,11,12,0,
,2021-10-19 14:00:00,661,310,351,Bedeckt,11,11,0,
,2021-10-19 15:00:00,1077,536,541,Bedeckt,10,10,0,
,2021-10-19 16:00:00,935,385,550,Bedeckt,11,10,0,
,2021-10-19 17:00:00,1175,486,689,Bewölkt,11,11,0,
,2021-10-19 18:00:00,856,396,460,Bewölkt,11,11,0,
,2021-10-19 19:00:00,628,299,329,Bewölkt,11,10,0,
,2021-10-19 20:00:00,375,166,209,Nieselregen,10,10,0.1,
,2021-10-19 21:00:00,245,126,119,Nieselregen,10,9,0.1,
,2021-10-19 22:00:00,208,82,126,Nieselregen,9,9,0,
,2021-10-19 23:00:00,136,40,96,Sonnig,9,8,0,
,2021-10-20 00:00:00,41,16,25,Sonnig,8,8,0,
,2021-10-20 01:00:00,43,9,34,Sonnig,8,8,0,
,2021-10-20 02:00:00,25,6,19,Sonnig,7,7,0,
,2021-10-20 03:00:00,3,1,2,Sonnig,7,7,0,
,2021-10-20 04:00:00,17,7,10,Sonnig,7,7,0,
,2021-10-20 05:00:00,57,35,22,Sonnig,7,7,0,
,2021-10-20 06:00:00,166,102,64,Sonnig,7,7,0,
,2021-10-20 07:00:00,1076,727,349,Sonnig,8,8,0,
,2021-10-20 08:00:00,762,476,286,Sonnig,9,9,0,
,2021-10-20 09:00:00,727,461,266,Sonnig,11,11,0,
,2021-10-20 10:00:00,471,245,226,Sonnig,13,13,0,
,2021-10-20 11:00:00,700,296,404,Sonnig,15,15,0,
,2021-10-20 12:00:00,699,312,387,Sonnig,17,17,0,
,2021-10-20 13:00:00,1125,590,535,Sonnig,18,18,0,
,2021-10-20 14:00:00,755,368,387,Sonnig,18,18,0,
,2021-10-20 15:00:00,1108,508,600,Sonnig,18,18,0,
,2021-10-20 16:00:00,948,445,503,Sonnig,16,16,0,
,2021-10-20 17:00:00,1125,492,633,Sonnig,14,14,0,
,2021-10-20 18:00:00,925,430,495,Sonnig,13,12,0,
,2021-10-20 19:00:00,606,324,282,Sonnig,12,11,0,
,2021-10-20 20:00:00,444,197,247,Leicht bewölkt,12,11,0,
,2021-10-20 21:00:00,291,119,172,Leicht bewölkt,11,10,0,
,2021-10-20 22:00:00,211,72,139,Leicht bewölkt,10,9,0,
,2021-10-20 23:00:00,149,38,111,Sonnig,9,8,0,
,2021-10-21 00:00:00,86,27,59,Sonnig,9,8,0,
,2021-10-21 01:00:00,57,20,37,Sonnig,9,8,0,
,2021-10-21 02:00:00,26,15,11,Leicht bewölkt,9,8,0,
,2021-10-21 03:00:00,19,8,11,Leicht bewölkt,10,9,0,
,2021-10-21 04:00:00,10,9,1,Leicht bewölkt,10,8,0,
,2021-10-21 05:00:00,28,24,4,Stellenweiser Nieselregen,10,8,0.1,
,2021-10-21 06:00:00,115,70,45,Stellenweiser Nieselregen,10,8,0.1,
,2021-10-21 07:00:00,711,490,221,Stellenweiser Nieselregen,11,8,0.1,
,2021-10-21 08:00:00,628,367,261,Leichter Regenfall,11,9,0.3,
,2021-10-21 09:00:00,615,361,254,Leichter Regenfall,12,9,0.4,
,2021-10-21 10:00:00,367,216,151,Leichter Regenfall,13,11,0.2,
,2021-10-21 11:00:00,509,263,246,Teilweise mäßiger Regenfall,14,14,0.2,
,2021-10-21 12:00:00,489,222,267,Teilweise mäßiger Regenfall,16,16,0.3,
,2021-10-21 13:00:00,789,359,430,Teilweise mäßiger Regenfall,15,15,0.1,
,2021-10-21 14:00:00,608,286,322,Leicht bewölkt,15,15,0,
,2021-10-21 15:00:00,909,430,479,Leicht bewölkt,15,15,0,
,2021-10-21 16:00:00,773,339,434,Leicht bewölkt,13,13,0,
,2021-10-21 17:00:00,1022,476,546,Sonnig,12,11,0,
,2021-10-21 18:00:00,807,376,431,Sonnig,10,9,0,
,2021-10-21 19:00:00,531,253,278,Sonnig,10,8,0,
,2021-10-21 20:00:00,348,195,153,Sonnig,9,7,0,
,2021-10-21 21:00:00,228,104,124,Sonnig,8,7,0,
,2021-10-21 22:00:00,213,88,125,Sonnig,7,5,0,
,2021-10-21 23:00:00,115,31,84,Nieselregen,6,3,0.1,
,2021-10-22 00:00:00,89,22,67,Nieselregen,5,2,0.2,
,2021-10-22 01:00:00,68,11,57,Nieselregen,5,2,0.1,
,2021-10-22 02:00:00,31,12,19,Leichter Regenfall,4,3,0.5,
,2021-10-22 03:00:00,12,9,3,Leichter Regenfall,4,4,0.6,
,2021-10-22 04:00:00,7,6,1,Leichter Regenfall,4,4,0.3,
,2021-10-22 05:00:00,37,27,10,Nieselregen,4,4,0.2,
,2021-10-22 06:00:00,143,83,60,Nieselregen,4,4,0.3,
,2021-10-22 07:00:00,831,526,305,Nieselregen,5,4,0.2,
,2021-10-22 08:00:00,620,366,254,Leicht bewölkt,5,4,0,
,2021-10-22 09:00:00,597,396,201,Leicht bewölkt,5,4,0,
,2021-10-22 10:00:00,375,207,168,Leicht bewölkt,6,5,0,
,2021-10-22 11:00:00,574,300,274,Bedeckt,7,6,0,
,2021-10-22 12:00:00,740,333,407,Bedeckt,8,6,0,
,2021-10-22 13:00:00,916,349,567,Bedeckt,8,7,0,
,2021-10-22 14:00:00,627,311,316,Sonnig,8,7,0,
,2021-10-22 15:00:00,718,332,386,Sonnig,8,7,0,
,2021-10-22 16:00:00,648,316,332,Sonnig,8,7,0,
,2021-10-22 17:00:00,681,326,355,Sonnig,7,7,0,
,2021-10-22 18:00:00,605,298,307,Sonnig,6,6,0,
,2021-10-22 19:00:00,477,235,242,Sonnig,5,5,0,
,2021-10-22 20:00:00,380,195,185,Sonnig,4,3,0,
,2021-10-22 21:00:00,256,135,121,Sonnig,3,2,0,
,2021-10-22 22:00:00,244,102,142,Sonnig,3,2,0,
,2021-10-22 23:00:00,166,58,108,Sonnig,3,2,0,
,2021-10-23 00:00:00,137,50,87,Sonnig,3,2,0,
,2021-10-23 01:00:00,129,34,95,Sonnig,2,2,0,
,2021-10-23 02:00:00,82,22,60,Sonnig,2,2,0,
,2021-10-23 03:00:00,58,23,35,Sonnig,1,1,0,
,2021-10-23 04:00:00,21,11,10,Sonnig,1,1,0,
,2021-10-23 05:00:00,39,28,11,Sonnig,1,1,0,
,2021-10-23 06:00:00,43,25,18,Sonnig,1,1,0,
,2021-10-23 07:00:00,83,34,49,Sonnig,3,3,0,
,2021-10-23 08:00:00,200,128,72,Sonnig,4,4,0,
,2021-10-23 09:00:00,343,203,140,Sonnig,6,6,0,
,2021-10-23 10:00:00,432,246,186,Sonnig,7,7,0,
,2021-10-23 11:00:00,470,232,238,Sonnig,9,9,0,
,2021-10-23 12:00:00,572,307,265,Sonnig,11,11,0,
,2021-10-23 13:00:00,591,315,276,Sonnig,11,10,0,
,2021-10-23 14:00:00,675,322,353,Sonnig,11,10,0,
,2021-10-23 15:00:00,693,336,357,Sonnig,11,10,0,
,2021-10-23 16:00:00,633,317,316,Sonnig,10,9,0,
,2021-10-23 17:00:00,554,244,310,Sonnig,9,7,0,
,2021-10-23 18:00:00,539,258,281,Sonnig,8,6,0,
,2021-10-23 19:00:00,365,179,186,Sonnig,6,4,0,
,2021-10-23 20:00:00,350,188,162,Sonnig,4,2,0,
,2021-10-23 21:00:00,228,99,129,Sonnig,3,0,0,
,2021-10-23 22:00:00,211,101,110,Sonnig,2,0,0,
,2021-10-23 23:00:00,130,56,74,Sonnig,2,0,0,
,2021-10-24 00:00:00,146,68,78,Sonnig,1,-1,0,
,2021-10-24 01:00:00,115,40,75,Sonnig,1,-1,0,
,2021-10-24 02:00:00,91,44,47,Leichter Nebel,1,-1,0,
,2021-10-24 03:00:00,70,25,45,Leichter Nebel,0,-1,0,
,2021-10-24 04:00:00,39,21,18,Leichter Nebel,0,-1,0,
,2021-10-24 05:00:00,17,10,7,Leichter Nebel,-1,-1,0,
,2021-10-24 06:00:00,20,16,4,Leichter Nebel,-1,-1,0,
,2021-10-24 07:00:00,36,18,18,Leichter Nebel,1,1,0,
,2021-10-24 08:00:00,68,37,31,Sonnig,3,3,0,
,2021-10-24 09:00:00,173,95,78,Sonnig,5,5,0,
,2021-10-24 10:00:00,175,93,82,Sonnig,7,7,0,
,2021-10-24 11:00:00,243,106,137,Sonnig,10,10,0,
,2021-10-24 12:00:00,276,125,151,Sonnig,13,13,0,
,2021-10-24 13:00:00,292,138,154,Sonnig,13,13,0,
,2021-10-24 14:00:00,411,202,209,Sonnig,14,14,0,
,2021-10-24 15:00:00,461,258,203,Sonnig,15,15,0,
,2021-10-24 16:00:00,411,205,206,Sonnig,13,13,0,
,2021-10-24 17:00:00,502,264,238,Sonnig,10,10,0,
,2021-10-24 18:00:00,356,175,181,Sonnig,8,8,0,
,2021-10-24 19:00:00,248,120,128,Sonnig,7,7,0,
,2021-10-24 20:00:00,187,85,102,Sonnig,5,5,0,
,2021-10-24 21:00:00,100,49,51,Sonnig,4,4,0,
,2021-10-24 22:00:00,115,63,52,Sonnig,3,3,0,
,2021-10-24 23:00:00,58,18,40,Sonnig,3,3,0,
,2021-10-25 00:00:00,47,15,32,Sonnig,3,3,0,
,2021-10-25 01:00:00,9,4,5,Sonnig,3,3,0,
,2021-10-25 02:00:00,5,2,3,Sonnig,3,3,0,
,2021-10-25 03:00:00,2,2,0,Sonnig,2,2,0,
,2021-10-25 04:00:00,12,4,8,Sonnig,2,2,0,
,2021-10-25 05:00:00,49,30,19,Sonnig,2,2,0,
,2021-10-25 06:00:00,143,97,46,Sonnig,2,2,0,
,2021-10-25 07:00:00,1078,681,397,Sonnig,4,4,0,
,2021-10-25 08:00:00,719,423,296,Sonnig,6,6,0,
,2021-10-25 09:00:00,607,373,234,Sonnig,7,7,0,
,2021-10-25 10:00:00,410,231,179,Sonnig,10,10,0,
,2021-10-25 11:00:00,627,278,349,Sonnig,12,12,0,
,2021-10-25 12:00:00,592,289,303,Sonnig,14,14,0,
,2021-10-25 13:00:00,957,427,530,Sonnig,14,14,0,
,2021-10-25 14:00:00,648,318,330,Sonnig,14,14,0,
,2021-10-25 15:00:00,1020,465,555,Sonnig,14,14,0,
,2021-10-25 16:00:00,864,367,497,Sonnig,12,12,0,
,2021-10-25 17:00:00,1083,487,596,Leicht bewölkt,10,10,0,
,2021-10-25 18:00:00,846,398,448,Leicht bewölkt,7,7,0,
,2021-10-25 19:00:00,581,274,307,Leicht bewölkt,7,7,0,
,2021-10-25 20:00:00,404,170,234,Leicht bewölkt,6,6,0,
,2021-10-25 21:00:00,247,106,141,Leicht bewölkt,6,6,0,
,2021-10-25 22:00:00,166,77,89,Leicht bewölkt,5,5,0,
,2021-10-25 23:00:00,92,20,72,Sonnig,4,4,0,
,2021-10-26 00:00:00,49,23,26,Sonnig,3,3,0,
,2021-10-26 01:00:00,24,10,14,Sonnig,3,3,0,
,2021-10-26 02:00:00,23,17,6,Leicht bewölkt,3,3,0,
,2021-10-26 03:00:00,19,11,8,Leicht bewölkt,3,3,0,
,2021-10-26 04:00:00,14,12,2,Leicht bewölkt,3,3,0,
,2021-10-26 05:00:00,51,35,16,Leicht bewölkt,3,3,0,
,2021-10-26 06:00:00,158,101,57,Leicht bewölkt,3,3,0,
,2021-10-26 07:00:00,915,573,342,Leicht bewölkt,4,4,0,
,2021-10-26 08:00:00,760,416,344,Nieselregen,5,5,0.2,
,2021-10-26 09:00:00,682,405,277,Nieselregen,6,6,0.3,
,2021-10-26 10:00:00,446,269,177,Nieselregen,7,7,0.2,
,2021-10-26 11:00:00,619,290,329,Nieselregen,9,8,0.1,
,2021-10-26 12:00:00,665,280,385,Nieselregen,10,10,0.1,
,2021-10-26 13:00:00,980,456,524,Nieselregen,11,11,0.1,
,2021-10-26 14:00:00,560,285,275,Leicht bewölkt,11,11,0,
,2021-10-26 15:00:00,968,481,487,Leicht bewölkt,12,12,0,
,2021-10-26 16:00:00,848,363,485,Leicht bewölkt,11,11,0,
,2021-10-26 17:00:00,986,437,549,Leicht bewölkt,10,10,0,
,2021-10-26 18:00:00,891,443,448,Leicht bewölkt,9,9,0,
,2021-10-26 19:00:00,652,325,327,Leicht bewölkt,9,9,0,
,2021-10-26 20:00:00,410,183,227,Leicht bewölkt,9,9,0,
,2021-10-26 21:00:00,263,107,156,Leicht bewölkt,9,9,0,
,2021-10-26 22:00:00,214,77,137,Leicht bewölkt,8,8,0,
,2021-10-26 23:00:00,129,56,73,Sonnig,6,6,0,
,2021-10-27 00:00:00,70,24,46,Sonnig,5,5,0,
,2021-10-27 01:00:00,35,8,27,Sonnig,5,5,0,
,2021-10-27 02:00:00,20,4,16,Sonnig,4,4,0,
,2021-10-27 03:00:00,8,4,4,Sonnig,4,4,0,
,2021-10-27 04:00:00,13,7,6,Sonnig,4,4,0,
,2021-10-27 05:00:00,58,32,26,Sonnig,4,4,0,
,2021-10-27 06:00:00,179,112,67,Sonnig,3,3,0,
,2021-10-27 07:00:00,1061,674,387,Sonnig,5,5,0,
,2021-10-27 08:00:00,808,468,340,Sonnig,7,7,0,
,2021-10-27 09:00:00,749,476,273,Sonnig,8,8,0,
,2021-10-27 10:00:00,411,226,185,Sonnig,10,10,0,
,2021-10-27 11:00:00,607,284,323,Sonnig,12,12,0,
,2021-10-27 12:00:00,718,325,393,Sonnig,14,14,0,
,2021-10-27 13:00:00,1059,537,522,Sonnig,14,15,0,
,2021-10-27 14:00:00,717,345,372,Sonnig,15,15,0,
,2021-10-27 15:00:00,980,438,542,Sonnig,15,15,0,
,2021-10-27 16:00:00,951,446,505,Sonnig,13,13,0,
,2021-10-27 17:00:00,1129,510,619,Sonnig,11,11,0,
,2021-10-27 18:00:00,986,468,518,Sonnig,9,9,0,
,2021-10-27 19:00:00,630,292,338,Sonnig,8,8,0,
,2021-10-27 20:00:00,490,219,271,Sonnig,7,7,0,
,2021-10-27 21:00:00,261,104,157,Sonnig,6,6,0,
,2021-10-27 22:00:00,269,106,163,Sonnig,5,5,0,
,2021-10-27 23:00:00,143,50,93,Sonnig,5,5,0,
,2021-10-28 00:00:00,91,30,61,Sonnig,4,4,0,
,2021-10-28 01:00:00,31,6,25,Sonnig,4,4,0,
,2021-10-28 02:00:00,15,5,10,Sonnig,3,3,0,
,2021-10-28 03:00:00,3,0,3,Sonnig,3,3,0,
,2021-10-28 04:00:00,15,11,4,Sonnig,3,3,0,
,2021-10-28 05:00:00,51,30,21,Sonnig,3,3,0,
,2021-10-28 06:00:00,166,98,68,Sonnig,3,3,0,
,2021-10-28 07:00:00,1021,666,355,Sonnig,4,4,0,
,2021-10-28 08:00:00,787,423,364,Sonnig,6,6,0,
,2021-10-28 09:00:00,776,425,351,Sonnig,8,8,0,
,2021-10-28 10:00:00,429,243,186,Sonnig,10,10,0,
,2021-10-28 11:00:00,632,312,320,Sonnig,13,13,0,
,2021-10-28 12:00:00,636,279,357,Sonnig,15,15,0,
,2021-10-28 13:00:00,982,438,544,Sonnig,16,16,0,
,2021-10-28 14:00:00,616,298,318,Sonnig,16,16,0,
,2021-10-28 15:00:00,1020,505,515,Sonnig,17,17,0,
,2021-10-28 16:00:00,868,432,436,Sonnig,14,14,0,
,2021-10-28 17:00:00,1034,505,529,Sonnig,12,12,0,
,2021-10-28 18:00:00,925,418,507,Sonnig,10,10,0,
,2021-10-28 19:00:00,631,281,350,Sonnig,8,8,0,
,2021-10-28 20:00:00,393,171,222,Sonnig,7,7,0,
,2021-10-28 21:00:00,241,97,144,Sonnig,5,5,0,
,2021-10-28 22:00:00,221,92,129,Sonnig,5,5,0,
,2021-10-28 23:00:00,150,49,101,Sonnig,5,5,0,
,2021-10-29 00:00:00,69,32,37,Sonnig,4,4,0,
,2021-10-29 01:00:00,48,12,36,Sonnig,4,4,0,
,2021-10-29 02:00:00,19,12,7,Sonnig,4,4,0,
,2021-10-29 03:00:00,14,6,8,Sonnig,3,3,0,
,2021-10-29 04:00:00,9,5,4,Sonnig,3,3,0,
,2021-10-29 05:00:00,44,29,15,Leicht bewölkt,3,3,0,
,2021-10-29 06:00:00,145,87,58,Leicht bewölkt,3,3,0,
,2021-10-29 07:00:00,936,577,359,Leicht bewölkt,5,5,0,
,2021-10-29 08:00:00,644,368,276,Leicht bewölkt,6,6,0,
,2021-10-29 09:00:00,626,411,215,Leicht bewölkt,8,8,0,
,2021-10-29 10:00:00,446,230,216,Leicht bewölkt,10,10,0,
,2021-10-29 11:00:00,683,325,358,Sonnig,11,11,0,
,2021-10-29 12:00:00,734,331,403,Sonnig,13,13,0,
,2021-10-29 13:00:00,986,400,586,Sonnig,13,14,0,
,2021-10-29 14:00:00,696,347,349,Sonnig,14,14,0,
,2021-10-29 15:00:00,720,305,415,Sonnig,14,15,0,
,2021-10-29 16:00:00,674,313,361,Sonnig,12,12,0,
,2021-10-29 17:00:00,703,329,374,Leicht bewölkt,10,10,0,
,2021-10-29 18:00:00,658,320,338,Leicht bewölkt,8,8,0,
,2021-10-29 19:00:00,447,213,234,Leicht bewölkt,8,7,0,
,2021-10-29 20:00:00,293,154,139,Bedeckt,8,7,0,
,2021-10-29 21:00:00,209,109,100,Bedeckt,7,7,0,
,2021-10-29 22:00:00,212,87,125,Bedeckt,6,6,0,
,2021-10-29 23:00:00,187,77,110,Sonnig,6,6,0,
,2021-10-30 00:00:00,147,56,91,Sonnig,5,5,0,
,2021-10-30 01:00:00,92,21,71,Sonnig,5,5,0,
,2021-10-30 02:00:00,83,24,59,Sonnig,4,4,0,
,2021-10-30 03:00:00,42,15,27,Sonnig,4,4,0,
,2021-10-30 04:00:00,24,8,16,Sonnig,4,4,0,
,2021-10-30 05:00:00,22,13,9,Sonnig,4,4,0,
,2021-10-30 06:00:00,57,29,28,Sonnig,4,3,0,
,2021-10-30 07:00:00,64,28,36,Sonnig,5,5,0,
,2021-10-30 08:00:00,167,81,86,Sonnig,7,7,0,
,2021-10-30 09:00:00,307,197,110,Sonnig,8,8,0,
,2021-10-30 10:00:00,395,228,167,Sonnig,10,10,0,
,2021-10-30 11:00:00,466,265,201,Sonnig,12,12,0,
,2021-10-30 12:00:00,423,230,193,Sonnig,13,13,0,
,2021-10-30 13:00:00,445,223,222,Sonnig,13,13,0,
,2021-10-30 14:00:00,413,181,232,Leicht bewölkt,13,13,0,
,2021-10-30 15:00:00,332,147,185,Leicht bewölkt,12,12,0,
,2021-10-30 16:00:00,358,169,189,Leicht bewölkt,11,11,0,
,2021-10-30 17:00:00,401,166,235,Bewölkt,10,10,0,
,2021-10-30 18:00:00,361,154,207,Bewölkt,8,9,0,
,2021-10-30 19:00:00,309,155,154,Bewölkt,8,8,0,
,2021-10-30 20:00:00,225,96,129,Sonnig,8,8,0,
,2021-10-30 21:00:00,186,85,101,Sonnig,8,7,0,
,2021-10-30 22:00:00,169,45,124,Sonnig,7,7,0,
,2021-10-30 23:00:00,133,43,90,Leicht bewölkt,7,7,0,
,2021-10-31 00:00:00,116,39,77,Leicht bewölkt,6,6,0,
,2021-10-31 01:00:00,89,43,46,Leicht bewölkt,6,6,0,
,2021-10-31 02:00:00,138,72,66,Sonnig,6,6,0,
,2021-10-31 03:00:00,58,42,16,Sonnig,6,6,0,
,2021-10-31 04:00:00,22,13,9,Sonnig,6,5,0,
,2021-10-31 05:00:00,33,22,11,Leicht bewölkt,6,5,0,
,2021-10-31 06:00:00,39,24,15,Leicht bewölkt,6,5,0,
,2021-10-31 07:00:00,44,23,21,Leicht bewölkt,7,6,0,
,2021-10-31 08:00:00,76,39,37,Sonnig,9,8,0,
,2021-10-31 09:00:00,165,80,85,Sonnig,10,10,0,
,2021-10-31 10:00:00,219,114,105,Sonnig,12,12,0,
,2021-10-31 11:00:00,315,150,165,Sonnig,14,14,0,
,2021-10-31 12:00:00,327,152,175,Sonnig,17,17,0,
,2021-10-31 13:00:00,390,206,184,Sonnig,17,17,0,
,2021-10-31 14:00:00,429,214,215,Sonnig,18,18,0,
,2021-10-31 15:00:00,491,259,232,Sonnig,18,18,0,
,2021-10-31 16:00:00,403,218,185,Sonnig,16,16,0,
,2021-10-31 17:00:00,392,205,187,Sonnig,13,13,0,
,2021-10-31 18:00:00,331,199,132,Sonnig,11,11,0,
,2021-10-31 19:00:00,246,125,121,Sonnig,10,10,0,
,2021-10-31 20:00:00,247,124,123,Sonnig,9,8,0,
,2021-10-31 21:00:00,183,80,103,Sonnig,8,7,0,
,2021-10-31 22:00:00,171,74,97,Sonnig,8,6,0,
,2021-10-31 23:00:00,93,43,50,Sonnig,7,6,0,
,2021-11-01 00:00:00,92,44,48,Sonnig,7,6,0,
,2021-11-01 01:00:00,119,56,63,Sonnig,7,6,0,
,2021-11-01 02:00:00,73,30,43,Leicht bewölkt,7,6,0,
,2021-11-01 03:00:00,57,24,33,Leicht bewölkt,7,6,0,
,2021-11-01 04:00:00,24,16,8,Leicht bewölkt,7,6,0,
,2021-11-01 05:00:00,28,17,11,Leicht bewölkt,7,6,0,
,2021-11-01 06:00:00,56,42,14,Leicht bewölkt,7,7,0,
,2021-11-01 07:00:00,69,50,19,Leicht bewölkt,8,7,0,
,2021-11-01 08:00:00,61,36,25,Bedeckt,9,8,0,
,2021-11-01 09:00:00,61,28,33,Bedeckt,11,9,0,
,2021-11-01 10:00:00,75,41,34,Bedeckt,10,9,0,
,2021-11-01 11:00:00,87,42,45,Nieselregen,10,9,0.1,
,2021-11-01 12:00:00,113,54,59,Nieselregen,10,9,0.2,
,2021-11-01 13:00:00,116,55,61,Nieselregen,10,9,0.1,
,2021-11-01 14:00:00,151,80,71,Nieselregen,10,9,0.1,
,2021-11-01 15:00:00,198,105,93,Nieselregen,10,9,0.1,
,2021-11-01 16:00:00,255,145,110,Nieselregen,9,9,0,
,2021-11-01 17:00:00,219,95,124,Leichter Regenfall,9,9,0.4,
,2021-11-01 18:00:00,235,105,130,Leichter Regenfall,9,10,0.5,
,2021-11-01 19:00:00,155,66,89,Leichter Regenfall,9,8,0.3,
,2021-11-01 20:00:00,126,44,82,Mäßiger Regenfall,8,7,1,
,2021-11-01 21:00:00,81,39,42,Mäßiger Regenfall,8,5,1.4,
,2021-11-01 22:00:00,93,44,49,Mäßiger Regenfall,8,5,0.7,
,2021-11-01 23:00:00,42,17,25,Leichter Regenschauer,7,5,0.3,
,2021-11-02 00:00:00,26,11,15,Leichter Regenschauer,7,5,0.6,
,2021-11-02 01:00:00,3,3,0,Leichter Regenschauer,6,5,0.3,
,2021-11-02 02:00:00,4,2,2,Bewölkt,6,4,0,
,2021-11-02 03:00:00,1,0,1,Bewölkt,6,4,0,
,2021-11-02 04:00:00,4,2,2,Bewölkt,5,3,0,
,2021-11-02 05:00:00,39,27,12,Sonnig,4,3,0,
,2021-11-02 06:00:00,162,102,60,Sonnig,4,2,0,
,2021-11-02 07:00:00,509,308,201,Sonnig,5,4,0,
,2021-11-02 08:00:00,516,287,229,Bewölkt,6,5,0,
,2021-11-02 09:00:00,430,248,182,Bewölkt,7,7,0,
,2021-11-02 10:00:00,249,131,118,Bewölkt,8,8,0,
,2021-11-02 11:00:00,379,221,158,Leicht bewölkt,10,9,0,
,2021-11-02 12:00:00,410,189,221,Leicht bewölkt,11,11,0,
,2021-11-02 13:00:00,542,281,261,Leicht bewölkt,11,11,0,
,2021-11-02 14:00:00,453,239,214,Leicht bewölkt,10,10,0,
,2021-11-02 15:00:00,532,263,269,Leicht bewölkt,10,10,0,
,2021-11-02 16:00:00,646,306,340,Leicht bewölkt,10,10,0,
,2021-11-02 17:00:00,789,334,455,Nieselregen,9,9,0.1,
,2021-11-02 18:00:00,596,282,314,Nieselregen,8,8,0.2,
,2021-11-02 19:00:00,499,221,278,Nieselregen,8,7,0.1,
,2021-11-02 20:00:00,294,145,149,Nieselregen,7,6,0.2,
,2021-11-02 21:00:00,169,76,93,Nieselregen,7,5,0.2,
,2021-11-02 22:00:00,145,63,82,Nieselregen,6,5,0.1,
,2021-11-02 23:00:00,124,44,80,Nieselregen,6,5,0.2,
,2021-11-03 00:00:00,42,14,28,Nieselregen,5,5,0.4,
,2021-11-03 01:00:00,22,11,11,Nieselregen,5,4,0.2,
,2021-11-03 02:00:00,12,6,6,Bedeckt,6,4,0,
,2021-11-03 03:00:00,4,2,2,Bedeckt,6,4,0,
,2021-11-03 04:00:00,10,8,2,Bedeckt,6,5,0,
,2021-11-03 05:00:00,49,31,18,Nieselregen,6,5,0.1,
,2021-11-03 06:00:00,140,89,51,Nieselregen,6,6,0.2,
,2021-11-03 07:00:00,495,319,176,Nieselregen,6,5,0.1,
,2021-11-03 08:00:00,553,306,247,Nieselregen,6,5,0.2,
,2021-11-03 09:00:00,561,339,222,Nieselregen,6,4,0.3,
,2021-11-03 10:00:00,427,223,204,Nieselregen,6,5,0.2,
,2021-11-03 11:00:00,527,239,288,Nieselregen,7,6,0.1,
,2021-11-03 12:00:00,500,236,264,Nieselregen,7,7,0.2,
,2021-11-03 13:00:00,591,287,304,Nieselregen,7,7,0.1,
,2021-11-03 14:00:00,377,166,211,Nieselregen,7,7,0.1,
,2021-11-03 15:00:00,460,208,252,Nieselregen,8,7,0.1,
,2021-11-03 16:00:00,529,227,302,Nieselregen,7,7,0,
,2021-11-03 17:00:00,625,278,347,Stellenweiser Regenfall,7,6,0,
,2021-11-03 18:00:00,531,235,296,Stellenweiser Regenfall,7,6,0,
,2021-11-03 19:00:00,400,172,228,Stellenweiser Regenfall,7,5,0,
,2021-11-03 20:00:00,267,130,137,Nieselregen,6,5,0.1,
,2021-11-03 21:00:00,190,77,113,Nieselregen,6,4,0.1,
,2021-11-03 22:00:00,157,74,83,Nieselregen,6,4,0,
,2021-11-03 23:00:00,111,48,63,Nieselregen,6,4,0.2,
,2021-11-04 00:00:00,63,25,38,Nieselregen,5,4,0.3,
,2021-11-04 01:00:00,28,11,17,Nieselregen,5,4,0.2,
,2021-11-04 02:00:00,15,11,4,Nieselregen,5,4,0.2,
,2021-11-04 03:00:00,11,9,2,Nieselregen,5,4,0.3,
,2021-11-04 04:00:00,14,13,1,Nieselregen,5,3,0.2,
,2021-11-04 05:00:00,35,21,14,Leichter Regenfall,5,3,0.4,
,2021-11-04 06:00:00,126,81,45,Leichter Regenfall,5,3,0.5,
,2021-11-04 07:00:00,450,292,158,Leichter Regenfall,4,2,0.2,
,2021-11-04 08:00:00,490,282,208,Leichter Eisregen,4,1,0.4,
,2021-11-04 09:00:00,516,274,242,Leichter Eisregen,3,1,0.5,
,2021-11-04 10:00:00,309,184,125,Leichter Eisregen,3,0,0.2,
,2021-11-04 11:00:00,426,220,206,Leichter Eisregen,3,0,0.6,
,2021-11-04 12:00:00,392,184,208,Leichter Eisregen,2,0,0.8,
,2021-11-04 13:00:00,548,275,273,Leichter Eisregen,2,0,0.4,
,2021-11-04 14:00:00,460,253,207,Leichter Eisregen,3,1,0.3,
,2021-11-04 15:00:00,601,266,335,Leichter Eisregen,3,1,0.4,
,2021-11-04 16:00:00,678,303,375,Leichter Eisregen,3,1,0.2,
,2021-11-04 17:00:00,743,350,393,Leichter Eisregen,3,1,0.4,
,2021-11-04 18:00:00,564,256,308,Leichter Eisregen,3,1,0.6,
,2021-11-04 19:00:00,456,218,238,Leichter Eisregen,3,1,0.3,
,2021-11-04 20:00:00,284,130,154,Leichter Eisregen,3,2,0.2,
,2021-11-04 21:00:00,175,69,106,Leichter Eisregen,3,2,0.2,
,2021-11-04 22:00:00,194,83,111,Leichter Eisregen,3,2,0.1,
,2021-11-04 23:00:00,121,51,70,Bewölkt,3,2,0,
,2021-11-05 00:00:00,71,35,36,Bewölkt,4,2,0,
,2021-11-05 01:00:00,33,8,25,Bewölkt,4,3,0,
,2021-11-05 02:00:00,12,3,9,Bedeckt,4,3,0,
,2021-11-05 03:00:00,8,3,5,Bedeckt,4,3,0,
,2021-11-05 04:00:00,8,2,6,Bedeckt,4,3,0,
,2021-11-05 05:00:00,54,39,15,Bedeckt,4,3,0,
,2021-11-05 06:00:00,141,84,57,Bedeckt,3,2,0,
,2021-11-05 07:00:00,414,242,172,Bedeckt,4,3,0,
,2021-11-05 08:00:00,503,294,209,Leicht bewölkt,4,3,0,
,2021-11-05 09:00:00,537,331,206,Leicht bewölkt,4,4,0,
,2021-11-05 10:00:00,383,211,172,Leicht bewölkt,5,5,0,
,2021-11-05 11:00:00,480,259,221,Sonnig,6,6,0,
,2021-11-05 12:00:00,490,225,265,Sonnig,8,7,0,
,2021-11-05 13:00:00,567,256,311,Sonnig,8,7,0,
,2021-11-05 14:00:00,570,288,282,Bewölkt,8,8,0,
,2021-11-05 15:00:00,527,257,270,Bewölkt,8,8,0,
,2021-11-05 16:00:00,637,283,354,Bewölkt,7,7,0,
,2021-11-05 17:00:00,673,318,355,Leicht bewölkt,7,6,0,
,2021-11-05 18:00:00,524,222,302,Leicht bewölkt,6,5,0,
,2021-11-05 19:00:00,399,188,211,Leicht bewölkt,6,5,0,
,2021-11-05 20:00:00,290,151,139,Leicht bewölkt,5,5,0,
,2021-11-05 21:00:00,210,106,104,Leicht bewölkt,5,5,0,
,2021-11-05 22:00:00,179,83,96,Leicht bewölkt,5,5,0,
,2021-11-05 23:00:00,129,53,76,Bewölkt,4,4,0,
,2021-11-06 00:00:00,147,64,83,Bewölkt,4,4,0,
,2021-11-06 01:00:00,85,24,61,Bewölkt,3,2,0,
,2021-11-06 02:00:00,75,15,60,Leicht bewölkt,2,1,0,
,2021-11-06 03:00:00,54,12,42,Leicht bewölkt,1,0,0,
,2021-11-06 04:00:00,29,9,20,Leicht bewölkt,1,-1,0,
,2021-11-06 05:00:00,29,16,13,Sonnig,0,-2,0,
,2021-11-06 06:00:00,61,29,32,Sonnig,-1,-3,0,
,2021-11-06 07:00:00,61,32,29,Sonnig,0,-1,0,
,2021-11-06 08:00:00,188,122,66,Sonnig,2,0,0,
,2021-11-06 09:00:00,299,169,130,Sonnig,3,2,0,
,2021-11-06 10:00:00,397,224,173,Sonnig,5,3,0,
,2021-11-06 11:00:00,436,222,214,Sonnig,7,5,0,
,2021-11-06 12:00:00,483,264,219,Sonnig,8,6,0,
,2021-11-06 13:00:00,509,268,241,Sonnig,8,6,0,
,2021-11-06 14:00:00,509,275,234,Bewölkt,8,6,0,
,2021-11-06 15:00:00,518,239,279,Bewölkt,8,6,0,
,2021-11-06 16:00:00,511,237,274,Bewölkt,6,4,0,
,2021-11-06 17:00:00,443,192,251,Sonnig,5,2,0,
,2021-11-06 18:00:00,419,183,236,Sonnig,3,0,0,
,2021-11-06 19:00:00,278,150,128,Sonnig,2,0,0,
,2021-11-06 20:00:00,235,113,122,Sonnig,1,0,0,
,2021-11-06 21:00:00,156,81,75,Sonnig,1,-1,0,
,2021-11-06 22:00:00,152,77,75,Sonnig,0,-1,0,
,2021-11-06 23:00:00,123,51,72,Sonnig,0,-1,0,
,2021-11-07 00:00:00,125,42,83,Sonnig,-1,-1,0,
,2021-11-07 01:00:00,106,22,84,Sonnig,-1,-2,0,
,2021-11-07 02:00:00,79,26,53,Sonnig,-1,-2,0,
,2021-11-07 03:00:00,64,20,44,Sonnig,-2,-3,0,
,2021-11-07 04:00:00,21,6,15,Sonnig,-2,-3,0,
,2021-11-07 05:00:00,27,12,15,Sonnig,-2,-2,0,
,2021-11-07 06:00:00,21,15,6,Sonnig,-2,-2,0,
,2021-11-07 07:00:00,34,16,18,Sonnig,-1,-1,0,
,2021-11-07 08:00:00,54,32,22,Bewölkt,0,0,0,
,2021-11-07 09:00:00,154,90,64,Bewölkt,2,2,0,
,2021-11-07 10:00:00,185,86,99,Bewölkt,4,4,0,
,2021-11-07 11:00:00,244,110,134,Sonnig,6,5,0,
,2021-11-07 12:00:00,265,130,135,Sonnig,8,7,0,
,2021-11-07 13:00:00,283,136,147,Sonnig,9,8,0,
,2021-11-07 14:00:00,379,187,192,Sonnig,9,9,0,
,2021-11-07 15:00:00,352,190,162,Sonnig,10,10,0,
,2021-11-07 16:00:00,306,138,168,Sonnig,9,9,0,
,2021-11-07 17:00:00,297,145,152,Leicht bewölkt,8,7,0,
,2021-11-07 18:00:00,218,135,83,Leicht bewölkt,7,6,0,
,2021-11-07 19:00:00,183,83,100,Leicht bewölkt,6,5,0,
,2021-11-07 20:00:00,116,47,69,Leicht bewölkt,6,5,0,
,2021-11-07 21:00:00,99,44,55,Leicht bewölkt,6,5,0,
,2021-11-07 22:00:00,94,44,50,Leicht bewölkt,6,5,0,
,2021-11-07 23:00:00,61,30,31,Leicht bewölkt,6,4,0,
,2021-11-08 00:00:00,27,14,13,Leicht bewölkt,6,4,0,
,2021-11-08 01:00:00,10,6,4,Leicht bewölkt,5,4,0,
,2021-11-08 02:00:00,6,2,4,Bedeckt,5,4,0,
,2021-11-08 03:00:00,7,2,5,Bedeckt,4,4,0,
,2021-11-08 04:00:00,10,4,6,Bedeckt,4,4,0,
,2021-11-08 05:00:00,47,23,24,Stellenweiser Regenfall,4,4,0,
,2021-11-08 06:00:00,172,103,69,Stellenweiser Regenfall,4,4,0,
,2021-11-08 07:00:00,1086,692,394,Stellenweiser Regenfall,4,4,0,
,2021-11-08 08:00:00,708,398,310,Leicht bewölkt,5,5,0,
,2021-11-08 09:00:00,623,396,227,Leicht bewölkt,5,5,0,
,2021-11-08 10:00:00,371,195,176,Leicht bewölkt,6,6,0,
,2021-11-08 11:00:00,537,272,265,Bewölkt,7,7,0,
,2021-11-08 12:00:00,561,241,320,Bewölkt,8,8,0,
,2021-11-08 13:00:00,939,419,520,Bewölkt,8,8,0,
,2021-11-08 14:00:00,587,293,294,Bedeckt,8,7,0,
,2021-11-08 15:00:00,908,434,474,Bedeckt,7,7,0,
,2021-11-08 16:00:00,817,385,432,Bedeckt,7,6,0,
,2021-11-08 17:00:00,973,429,544,Bewölkt,6,5,0,
,2021-11-08 18:00:00,719,318,401,Bewölkt,5,4,0,
,2021-11-08 19:00:00,588,235,353,Bewölkt,5,3,0,
,2021-11-08 20:00:00,328,144,184,Bewölkt,4,3,0,
,2021-11-08 21:00:00,187,83,104,Bewölkt,4,2,0,
,2021-11-08 22:00:00,174,75,99,Bewölkt,4,2,0,
,2021-11-08 23:00:00,78,37,41,Leicht bewölkt,3,2,0,
,2021-11-09 00:00:00,30,19,11,Leicht bewölkt,3,1,0,
,2021-11-09 01:00:00,15,6,9,Leicht bewölkt,3,0,0,
,2021-11-09 02:00:00,11,7,4,Sonnig,2,-1,0,
,2021-11-09 03:00:00,8,5,3,Sonnig,1,-2,0,
,2021-11-09 04:00:00,8,5,3,Sonnig,0,-2,0,
,2021-11-09 05:00:00,44,30,14,Sonnig,0,-2,0,
,2021-11-09 06:00:00,201,115,86,Sonnig,-1,-3,0,
,2021-11-09 07:00:00,1058,671,387,Sonnig,1,-1,0,
,2021-11-09 08:00:00,790,439,351,Sonnig,2,0,0,
,2021-11-09 09:00:00,764,445,319,Sonnig,3,2,0,
,2021-11-09 10:00:00,451,255,196,Sonnig,6,4,0,
,2021-11-09 11:00:00,623,332,291,Sonnig,8,7,0,
,2021-11-09 12:00:00,684,294,390,Sonnig,11,9,0,
,2021-11-09 13:00:00,957,449,508,Sonnig,10,9,0,
,2021-11-09 14:00:00,606,294,312,Sonnig,10,8,0,
,2021-11-09 15:00:00,1019,491,528,Sonnig,9,8,0,
,2021-11-09 16:00:00,913,406,507,Sonnig,7,5,0,
,2021-11-09 17:00:00,1034,446,588,Sonnig,5,3,0,
,2021-11-09 18:00:00,768,370,398,Sonnig,3,0,0,
,2021-11-09 19:00:00,537,258,279,Sonnig,2,0,0,
,2021-11-09 20:00:00,351,164,187,Sonnig,1,-1,0,
,2021-11-09 21:00:00,219,77,142,Sonnig,0,-1,0,
,2021-11-09 22:00:00,169,68,101,Sonnig,0,-1,0,
,2021-11-09 23:00:00,111,45,66,Sonnig,-1,-1,0,
,2021-11-10 00:00:00,32,10,22,Sonnig,-1,-1,0,
,2021-11-10 01:00:00,20,5,15,Sonnig,-1,-1,0,
,2021-11-10 02:00:00,8,3,5,Sonnig,-1,-1,0,
,2021-11-10 03:00:00,6,3,3,Sonnig,-1,-1,0,
,2021-11-10 04:00:00,11,5,6,Sonnig,-1,-1,0,
,2021-11-10 05:00:00,52,27,25,Sonnig,-1,-1,0,
,2021-11-10 06:00:00,186,117,69,Sonnig,-1,-1,0,
,2021-11-10 07:00:00,1087,686,401,Sonnig,0,0,0,
,2021-11-10 08:00:00,768,448,320,Sonnig,2,2,0,
,2021-11-10 09:00:00,696,395,301,Sonnig,3,3,0,
,2021-11-10 10:00:00,401,222,179,Sonnig,6,6,0,
,2021-11-10 11:00:00,553,228,325,Sonnig,8,8,0,
,2021-11-10 12:00:00,568,267,301,Sonnig,11,11,0,
,2021-11-10 13:00:00,944,456,488,Sonnig,11,11,0,
,2021-11-10 14:00:00,700,362,338,Sonnig,12,12,0,
,2021-11-10 15:00:00,892,397,495,Sonnig,12,12,0,
,2021-11-10 16:00:00,874,376,498,Sonnig,10,10,0,
,2021-11-10 17:00:00,944,426,518,Sonnig,7,7,0,
,2021-11-10 18:00:00,750,352,398,Sonnig,5,5,0,
,2021-11-10 19:00:00,518,234,284,Sonnig,4,4,0,
,2021-11-10 20:00:00,389,186,203,Sonnig,2,2,0,
,2021-11-10 21:00:00,265,106,159,Sonnig,1,1,0,
,2021-11-10 22:00:00,209,81,128,Sonnig,1,1,0,
,2021-11-10 23:00:00,117,33,84,Sonnig,2,2,0,
,2021-11-11 00:00:00,35,15,20,Sonnig,2,2,0,
,2021-11-11 01:00:00,29,13,16,Sonnig,2,2,0,
,2021-11-11 02:00:00,11,7,4,Sonnig,2,2,0,
,2021-11-11 03:00:00,5,3,2,Sonnig,2,2,0,
,2021-11-11 04:00:00,17,14,3,Sonnig,2,2,0,
,2021-11-11 05:00:00,55,30,25,Sonnig,2,2,0,
,2021-11-11 06:00:00,182,119,63,Sonnig,2,2,0,
,2021-11-11 07:00:00,978,612,366,Sonnig,3,3,0,
,2021-11-11 08:00:00,764,409,355,Sonnig,4,4,0,
,2021-11-11 09:00:00,705,410,295,Sonnig,5,5,0,
,2021-11-11 10:00:00,388,226,162,Sonnig,7,7,0,
,2021-11-11 11:00:00,558,298,260,Sonnig,9,9,0,
,2021-11-11 12:00:00,630,272,358,Sonnig,12,12,0,
,2021-11-11 13:00:00,890,399,491,Sonnig,12,12,0,
,2021-11-11 14:00:00,666,331,335,Sonnig,12,12,0,
,2021-11-11 15:00:00,991,449,542,Sonnig,13,13,0,
,2021-11-11 16:00:00,826,402,424,Sonnig,11,11,0,
,2021-11-11 17:00:00,930,454,476,Sonnig,9,8,0,
,2021-11-11 18:00:00,863,392,471,Sonnig,7,6,0,
,2021-11-11 19:00:00,495,241,254,Sonnig,6,5,0,
,2021-11-11 20:00:00,441,199,242,Sonnig,5,4,0,
,2021-11-11 21:00:00,247,111,136,Sonnig,4,3,0,
,2021-11-11 22:00:00,235,89,146,Sonnig,3,3,0,
,2021-11-11 23:00:00,168,59,109,Sonnig,3,2,0,
,2021-11-12 00:00:00,89,23,66,Sonnig,3,2,0,
,2021-11-12 01:00:00,76,13,63,Sonnig,3,1,0,
,2021-11-12 02:00:00,16,6,10,Leichter Nebel,2,1,0,
,2021-11-12 03:00:00,15,2,13,Leichter Nebel,2,1,0,
,2021-11-12 04:00:00,11,6,5,Leichter Nebel,2,1,0,
,2021-11-12 05:00:00,49,32,17,Leichter Nebel,2,1,0,
,2021-11-12 06:00:00,160,96,64,Leichter Nebel,2,1,0,
,2021-11-12 07:00:00,926,550,376,Leichter Nebel,3,2,0,
,2021-11-12 08:00:00,672,381,291,Leicht bewölkt,4,3,0,
,2021-11-12 09:00:00,636,414,222,Leicht bewölkt,5,5,0,
,2021-11-12 10:00:00,532,274,258,Leicht bewölkt,7,7,0,
,2021-11-12 11:00:00,589,288,301,Leicht bewölkt,8,8,0,
,2021-11-12 12:00:00,702,321,381,Leicht bewölkt,10,10,0,
,2021-11-12 13:00:00,977,391,586,Leicht bewölkt,10,10,0,
,2021-11-12 14:00:00,650,338,312,Sonnig,11,11,0,
,2021-11-12 15:00:00,701,313,388,Sonnig,11,11,0,
,2021-11-12 16:00:00,634,268,366,Sonnig,9,9,0,
,2021-11-12 17:00:00,618,287,331,Leicht bewölkt,7,7,0,
,2021-11-12 18:00:00,535,234,301,Leicht bewölkt,5,5,0,
,2021-11-12 19:00:00,480,239,241,Leicht bewölkt,5,5,0,
,2021-11-12 20:00:00,320,166,154,Sonnig,5,5,0,
,2021-11-12 21:00:00,205,103,102,Sonnig,4,4,0,
,2021-11-12 22:00:00,182,72,110,Sonnig,4,4,0,
,2021-11-12 23:00:00,155,60,95,Leicht bewölkt,4,4,0,
,2021-11-13 00:00:00,104,32,72,Leicht bewölkt,5,4,0,
,2021-11-13 01:00:00,87,28,59,Leicht bewölkt,5,4,0,
,2021-11-13 02:00:00,53,13,40,Bedeckt,5,4,0,
,2021-11-13 03:00:00,49,14,35,Bedeckt,5,4,0,
,2021-11-13 04:00:00,16,9,7,Bedeckt,5,4,0,
,2021-11-13 05:00:00,30,12,18,Bedeckt,5,5,0,
,2021-11-13 06:00:00,44,28,16,Bedeckt,6,5,0,
,2021-11-13 07:00:00,67,29,38,Bedeckt,6,6,0,
,2021-11-13 08:00:00,143,79,64,Stellenweiser Nieselregen,7,6,0.1,
,2021-11-13 09:00:00,266,153,113,Stellenweiser Nieselregen,7,7,0.1,
,2021-11-13 10:00:00,342,208,134,Stellenweiser Nieselregen,8,7,0,
,2021-11-13 11:00:00,373,185,188,Nieselregen,8,7,0.2,
,2021-11-13 12:00:00,419,215,204,Nieselregen,9,7,0.2,
,2021-11-13 13:00:00,383,184,199,Nieselregen,9,7,0.1,
,2021-11-13 14:00:00,377,182,195,Leichter Regenfall,8,7,0.5,
,2021-11-13 15:00:00,323,129,194,Leichter Regenfall,8,6,0.6,
,2021-11-13 16:00:00,343,163,180,Leichter Regenfall,8,7,0.3,
,2021-11-13 17:00:00,338,155,183,Leichter Regenfall,8,7,0.3,
,2021-11-13 18:00:00,315,121,194,Leichter Regenfall,8,7,0.4,
,2021-11-13 19:00:00,283,154,129,Leichter Regenfall,7,7,0.2,
,2021-11-13 20:00:00,211,99,112,Bedeckt,7,7,0,
,2021-11-13 21:00:00,177,79,98,Bedeckt,7,6,0,
,2021-11-13 22:00:00,154,70,84,Bedeckt,7,6,0,
,2021-11-13 23:00:00,142,56,86,Leichter Regenschauer,8,6,0.1,
,2021-11-14 00:00:00,103,43,60,Leichter Regenschauer,8,6,0.1,
,2021-11-14 01:00:00,113,31,82,Leichter Regenschauer,8,6,0.1,
,2021-11-14 02:00:00,59,21,38,Nieselregen,7,6,0.2,
,2021-11-14 03:00:00,47,12,35,Nieselregen,7,6,0.2,
,2021-11-14 04:00:00,22,5,17,Nieselregen,7,6,0.1,
,2021-11-14 05:00:00,21,11,10,Leichter Regenschauer,7,7,0.1,
,2021-11-14 06:00:00,36,23,13,Leichter Regenschauer,7,7,0.2,
,2021-11-14 07:00:00,53,19,34,Leichter Regenschauer,8,8,0.1,
,2021-11-14 08:00:00,49,26,23,Stellenweiser Regenfall,8,8,0,
,2021-11-14 09:00:00,95,57,38,Stellenweiser Regenfall,8,8,0,
,2021-11-14 10:00:00,171,89,82,Stellenweiser Regenfall,9,8,0,
,2021-11-14 11:00:00,165,97,68,Stellenweiser Regenfall,9,9,0,
,2021-11-14 12:00:00,181,77,104,Stellenweiser Regenfall,10,9,0,
,2021-11-14 13:00:00,196,91,105,Stellenweiser Regenfall,10,8,0,
,2021-11-14 14:00:00,274,129,145,Stellenweiser Regenfall,10,8,0,
,2021-11-14 15:00:00,248,132,116,Stellenweiser Regenfall,10,8,0,
,2021-11-14 16:00:00,296,129,167,Stellenweiser Regenfall,9,7,0,
,2021-11-14 17:00:00,295,152,143,Bewölkt,8,6,0,
,2021-11-14 18:00:00,189,104,85,Bewölkt,8,5,0,
,2021-11-14 19:00:00,190,85,105,Bewölkt,8,5,0,
,2021-11-14 20:00:00,176,98,78,Bewölkt,8,6,0,
,2021-11-14 21:00:00,82,37,45,Bewölkt,8,6,0,
,2021-11-14 22:00:00,95,49,46,Bewölkt,7,5,0,
,2021-11-14 23:00:00,50,26,24,Bewölkt,7,5,0,
,2021-11-15 00:00:00,27,8,19,Bewölkt,6,4,0,
,2021-11-15 01:00:00,9,5,4,Bewölkt,5,4,0,
,2021-11-15 02:00:00,8,5,3,Leicht bewölkt,5,4,0,
,2021-11-15 03:00:00,0,0,0,Leicht bewölkt,4,3,0,
,2021-11-15 04:00:00,6,3,3,Leicht bewölkt,4,3,0,
,2021-11-15 05:00:00,40,24,16,Leichter Nebel,3,2,0,
,2021-11-15 06:00:00,157,96,61,Leichter Nebel,3,2,0,
,2021-11-15 07:00:00,991,627,364,Leichter Nebel,4,3,0,
,2021-11-15 08:00:00,723,402,321,Bewölkt,4,4,0,
,2021-11-15 09:00:00,678,420,258,Bewölkt,5,5,0,
,2021-11-15 10:00:00,355,191,164,Bewölkt,6,6,0,
,2021-11-15 11:00:00,580,272,308,Bewölkt,7,7,0,
,2021-11-15 12:00:00,527,243,284,Bewölkt,8,8,0,
,2021-11-15 13:00:00,897,407,490,Bewölkt,9,8,0,
,2021-11-15 14:00:00,557,271,286,Bewölkt,9,8,0,
,2021-11-15 15:00:00,861,386,475,Bewölkt,9,9,0,
,2021-11-15 16:00:00,763,358,405,Bewölkt,8,7,0,
,2021-11-15 17:00:00,930,424,506,Leicht bewölkt,7,6,0,
,2021-11-15 18:00:00,675,302,373,Leicht bewölkt,5,5,0,
,2021-11-15 19:00:00,547,254,293,Leicht bewölkt,5,5,0,
,2021-11-15 20:00:00,346,149,197,Bewölkt,5,5,0,
,2021-11-15 21:00:00,191,78,113,Bewölkt,5,5,0,
,2021-11-15 22:00:00,176,72,104,Bewölkt,5,5,0,
,2021-11-15 23:00:00,90,23,67,Bewölkt,5,5,0,
,2021-11-16 00:00:00,33,16,17,Bewölkt,4,4,0,
,2021-11-16 01:00:00,22,8,14,Bewölkt,4,4,0,
,2021-11-16 02:00:00,15,10,5,Bedeckt,4,4,0,
,2021-11-16 03:00:00,13,9,4,Bedeckt,4,4,0,
,2021-11-16 04:00:00,13,11,2,Bedeckt,4,4,0,
,2021-11-16 05:00:00,48,31,17,Bewölkt,4,4,0,
,2021-11-16 06:00:00,152,91,61,Bewölkt,4,4,0,
,2021-11-16 07:00:00,997,627,370,Bewölkt,5,5,0,
,2021-11-16 08:00:00,770,403,367,Bewölkt,6,6,0,
,2021-11-16 09:00:00,732,436,296,Bewölkt,7,7,0,
,2021-11-16 10:00:00,396,209,187,Bewölkt,8,8,0,
,2021-11-16 11:00:00,574,273,301,Bewölkt,9,9,0,
,2021-11-16 12:00:00,589,245,344,Bewölkt,10,10,0,
,2021-11-16 13:00:00,864,376,488,Bewölkt,10,10,0,
,2021-11-16 14:00:00,576,279,297,Leicht bewölkt,10,10,0,
,2021-11-16 15:00:00,927,471,456,Leicht bewölkt,10,10,0,
,2021-11-16 16:00:00,809,355,454,Leicht bewölkt,9,9,0,
,2021-11-16 17:00:00,902,385,517,Leicht bewölkt,8,8,0,
,2021-11-16 18:00:00,709,324,385,Leicht bewölkt,7,7,0,
,2021-11-16 19:00:00,471,213,258,Leicht bewölkt,7,7,0,
,2021-11-16 20:00:00,360,169,191,Bewölkt,6,6,0,
,2021-11-16 21:00:00,226,103,123,Bewölkt,6,6,0,
,2021-11-16 22:00:00,196,78,118,Bewölkt,6,6,0,
,2021-11-16 23:00:00,90,38,52,Bedeckt,6,6,0,
,2021-11-17 00:00:00,46,23,23,Bedeckt,7,7,0,
,2021-11-17 01:00:00,31,10,21,Bedeckt,6,6,0,
,2021-11-17 02:00:00,4,3,1,Bedeckt,6,6,0,
,2021-11-17 03:00:00,5,3,2,Bedeckt,6,6,0,
,2021-11-17 04:00:00,11,7,4,Bedeckt,6,6,0,
,2021-11-17 05:00:00,48,31,17,Bedeckt,6,6,0,
,2021-11-17 06:00:00,151,92,59,Bedeckt,6,5,0,
,2021-11-17 07:00:00,1012,650,362,Bedeckt,6,6,0,
,2021-11-17 08:00:00,762,419,343,Bedeckt,6,6,0,
,2021-11-17 09:00:00,675,402,273,Bedeckt,6,6,0,
,2021-11-17 10:00:00,398,211,187,Bedeckt,7,7,0,
,2021-11-17 11:00:00,575,269,306,Bewölkt,8,7,0,
,2021-11-17 12:00:00,564,255,309,Bewölkt,8,8,0,
,2021-11-17 13:00:00,898,427,471,Bewölkt,8,8,0,
,2021-11-17 14:00:00,633,320,313,Bedeckt,8,8,0,
,2021-11-17 15:00:00,903,408,495,Bedeckt,9,8,0,
,2021-11-17 16:00:00,873,398,475,Bedeckt,8,7,0,
,2021-11-17 17:00:00,938,400,538,Leicht bewölkt,7,6,0,
,2021-11-17 18:00:00,774,367,407,Leicht bewölkt,6,5,0,
,2021-11-17 19:00:00,505,227,278,Leicht bewölkt,6,5,0,
,2021-11-17 20:00:00,399,189,210,Leicht bewölkt,5,5,0,
,2021-11-17 21:00:00,227,102,125,Leicht bewölkt,5,5,0,
,2021-11-17 22:00:00,217,102,115,Leicht bewölkt,6,5,0,
,2021-11-17 23:00:00,111,39,72,Leicht bewölkt,6,6,0,
,2021-11-18 00:00:00,63,15,48,Leicht bewölkt,6,6,0,
,2021-11-18 01:00:00,26,7,19,Leicht bewölkt,6,6,0,
,2021-11-18 02:00:00,21,7,14,Leicht bewölkt,6,6,0,
,2021-11-18 03:00:00,3,0,3,Leicht bewölkt,6,6,0,
,2021-11-18 04:00:00,11,7,4,Leicht bewölkt,5,5,0,
,2021-11-18 05:00:00,44,26,18,Bewölkt,5,5,0,
,2021-11-18 06:00:00,149,82,67,Bewölkt,5,4,0,
,2021-11-18 07:00:00,995,665,330,Bewölkt,5,4,0,
,2021-11-18 08:00:00,755,402,353,Leicht bewölkt,5,5,0,
,2021-11-18 09:00:00,685,387,298,Leicht bewölkt,6,6,0,
,2021-11-18 10:00:00,424,231,193,Leicht bewölkt,7,7,0,
,2021-11-18 11:00:00,602,295,307,Sonnig,8,8,0,
,2021-11-18 12:00:00,602,270,332,Sonnig,9,10,0,
,2021-11-18 13:00:00,890,420,470,Sonnig,9,9,0,
,2021-11-18 14:00:00,604,285,319,Leicht bewölkt,9,9,0,
,2021-11-18 15:00:00,920,424,496,Leicht bewölkt,9,9,0,
,2021-11-18 16:00:00,710,278,432,Leicht bewölkt,8,8,0,
,2021-11-18 17:00:00,826,340,486,Leicht bewölkt,6,6,0,
,2021-11-18 18:00:00,674,297,377,Leicht bewölkt,5,5,0,
,2021-11-18 19:00:00,577,299,278,Leicht bewölkt,4,4,0,
,2021-11-18 20:00:00,375,162,213,Leicht bewölkt,4,4,0,
,2021-11-18 21:00:00,306,112,194,Leicht bewölkt,4,4,0,
,2021-11-18 22:00:00,267,71,196,Leicht bewölkt,3,3,0,
,2021-11-18 23:00:00,108,36,72,Leicht bewölkt,2,2,0,
,2021-11-19 00:00:00,85,31,54,Leicht bewölkt,2,2,0,
,2021-11-19 01:00:00,55,18,37,Leicht bewölkt,2,2,0,
,2021-11-19 02:00:00,14,2,12,Leicht bewölkt,1,1,0,
,2021-11-19 03:00:00,6,4,2,Leicht bewölkt,1,1,0,
,2021-11-19 04:00:00,19,13,6,Leicht bewölkt,1,1,0,
,2021-11-19 05:00:00,38,25,13,Sonnig,2,2,0,
,2021-11-19 06:00:00,141,85,56,Sonnig,2,2,0,
,2021-11-19 07:00:00,922,577,345,Sonnig,3,3,0,
,2021-11-19 08:00:00,689,383,306,Sonnig,3,3,0,
,2021-11-19 09:00:00,635,391,244,Sonnig,4,4,0,
,2021-11-19 10:00:00,421,238,183,Sonnig,6,6,0,
,2021-11-19 11:00:00,628,305,323,Sonnig,8,8,0,
,2021-11-19 12:00:00,690,314,376,Sonnig,10,10,0,
,2021-11-19 13:00:00,890,341,549,Sonnig,10,10,0,
,2021-11-19 14:00:00,622,314,308,Sonnig,11,11,0,
,2021-11-19 15:00:00,670,301,369,Sonnig,11,11,0,
,2021-11-19 16:00:00,602,277,325,Sonnig,10,10,0,
,2021-11-19 17:00:00,629,313,316,Sonnig,9,9,0,
,2021-11-19 18:00:00,562,282,280,Sonnig,7,7,0,
,2021-11-19 19:00:00,518,309,209,Sonnig,6,6,0,
,2021-11-19 20:00:00,283,145,138,Sonnig,5,5,0,
,2021-11-19 21:00:00,244,88,156,Sonnig,4,4,0,
,2021-11-19 22:00:00,246,65,181,Sonnig,4,4,0,
,2021-11-19 23:00:00,150,54,96,Sonnig,3,3,0,
,2021-11-20 00:00:00,120,33,87,Sonnig,3,3,0,
,2021-11-20 01:00:00,94,28,66,Sonnig,3,3,0,
,2021-11-20 02:00:00,74,27,47,Sonnig,3,3,0,
,2021-11-20 03:00:00,32,8,24,Sonnig,2,2,0,
,2021-11-20 04:00:00,18,4,14,Sonnig,2,2,0,
,2021-11-20 05:00:00,42,22,20,Sonnig,2,2,0,
,2021-11-20 06:00:00,38,23,15,Sonnig,2,2,0,
,2021-11-20 07:00:00,70,35,35,Sonnig,3,3,0,
,2021-11-20 08:00:00,166,93,73,Sonnig,4,4,0,
,2021-11-20 09:00:00,335,225,110,Sonnig,5,5,0,
,2021-11-20 10:00:00,404,223,181,Sonnig,6,6,0,
,2021-11-20 11:00:00,457,230,227,Sonnig,8,8,0,
,2021-11-20 12:00:00,480,240,240,Sonnig,10,10,0,
,2021-11-20 13:00:00,516,252,264,Sonnig,10,10,0,
,2021-11-20 14:00:00,500,239,261,Sonnig,10,10,0,
,2021-11-20 15:00:00,476,223,253,Sonnig,10,10,0,
,2021-11-20 16:00:00,466,239,227,Sonnig,8,8,0,
,2021-11-20 17:00:00,394,201,193,Sonnig,7,6,0,
,2021-11-20 18:00:00,405,183,222,Sonnig,5,5,0,
,2021-11-20 19:00:00,325,164,161,Sonnig,4,4,0,
,2021-11-20 20:00:00,233,99,134,Sonnig,3,3,0,
,2021-11-20 21:00:00,207,78,129,Sonnig,2,2,0,
,2021-11-20 22:00:00,163,58,105,Sonnig,2,2,0,
,2021-11-20 23:00:00,156,63,93,Leicht bewölkt,2,2,0,
,2021-11-21 00:00:00,120,43,77,Leicht bewölkt,2,2,0,
,2021-11-21 01:00:00,98,29,69,Leicht bewölkt,2,2,0,
,2021-11-21 02:00:00,60,16,44,Sonnig,2,2,0,
,2021-11-21 03:00:00,34,10,24,Sonnig,2,2,0,
,2021-11-21 04:00:00,26,8,18,Sonnig,1,1,0,
,2021-11-21 05:00:00,20,6,14,Sonnig,1,1,0,
,2021-11-21 06:00:00,21,13,8,Sonnig,1,0,0,
,2021-11-21 07:00:00,30,15,15,Sonnig,2,1,0,
,2021-11-21 08:00:00,74,35,39,Sonnig,3,2,0,
,2021-11-21 09:00:00,134,87,47,Sonnig,4,3,0,
,2021-11-21 10:00:00,194,97,97,Sonnig,6,5,0,
,2021-11-21 11:00:00,254,110,144,Sonnig,8,7,0,
,2021-11-21 12:00:00,283,138,145,Sonnig,10,10,0,
,2021-11-21 13:00:00,284,128,156,Sonnig,10,10,0,
,2021-11-21 14:00:00,352,158,194,Sonnig,10,10,0,
,2021-11-21 15:00:00,345,211,134,Sonnig,11,10,0,
,2021-11-21 16:00:00,357,187,170,Sonnig,9,8,0,
,2021-11-21 17:00:00,280,116,164,Sonnig,7,7,0,
,2021-11-21 18:00:00,281,116,165,Sonnig,5,5,0,
,2021-11-21 19:00:00,173,86,87,Sonnig,5,5,0,
,2021-11-21 20:00:00,125,64,61,Leicht bewölkt,4,4,0,
,2021-11-21 21:00:00,115,45,70,Leicht bewölkt,4,4,0,
,2021-11-21 22:00:00,90,47,43,Leicht bewölkt,4,4,0,
,2021-11-21 23:00:00,40,14,26,Leicht bewölkt,4,4,0,
,2021-11-22 00:00:00,25,12,13,Leicht bewölkt,4,4,0,
,2021-11-22 01:00:00,6,5,1,Leicht bewölkt,4,3,0,
,2021-11-22 02:00:00,10,3,7,Stellenweiser Regenfall,5,3,0,
,2021-11-22 03:00:00,1,0,1,Stellenweiser Regenfall,5,3,0,
,2021-11-22 04:00:00,10,5,5,Stellenweiser Regenfall,5,2,0,
,2021-11-22 05:00:00,35,23,12,Nieselregen,5,2,0.1,
,2021-11-22 06:00:00,147,92,55,Nieselregen,5,1,0.2,
,2021-11-22 07:00:00,1003,622,381,Nieselregen,4,1,0.1,
,2021-11-22 08:00:00,663,386,277,Nieselregen,4,1,0.1,
,2021-11-22 09:00:00,571,332,239,Nieselregen,4,0,0.1,
,2021-11-22 10:00:00,359,198,161,Nieselregen,4,0,0,
,2021-11-22 11:00:00,524,241,283,Leichter Regenschauer,4,0,0.1,
,2021-11-22 12:00:00,493,219,274,Leichter Regenschauer,5,0,0.1,
,2021-11-22 13:00:00,841,398,443,Leichter Regenschauer,5,0,0,
,2021-11-22 14:00:00,521,240,281,Stellenweiser Regenfall,5,0,0,
,2021-11-22 15:00:00,853,418,435,Stellenweiser Regenfall,5,0,0,
,2021-11-22 16:00:00,705,356,349,Stellenweiser Regenfall,5,0,0,
,2021-11-22 17:00:00,856,413,443,Leichter Regenschauer,5,0,0.1,
,2021-11-22 18:00:00,688,338,350,Leichter Regenschauer,5,0,0.1,
,2021-11-22 19:00:00,470,189,281,Leichter Regenschauer,4,0,0,
,2021-11-22 20:00:00,325,155,170,Nieselregen,4,0,0.1,
,2021-11-22 21:00:00,217,90,127,Nieselregen,4,0,0.1,
,2021-11-22 22:00:00,132,51,81,Nieselregen,4,-1,0,
,2021-11-22 23:00:00,69,26,43,Stellenweiser Regenfall,3,-2,0,
,2021-11-23 00:00:00,46,11,35,Stellenweiser Regenfall,2,-2,0.1,
,2021-11-23 01:00:00,28,13,15,Stellenweiser Regenfall,2,-3,0,
,2021-11-23 02:00:00,10,6,4,Bedeckt,2,-3,0,
,2021-11-23 03:00:00,3,1,2,Bedeckt,2,-3,0,
,2021-11-23 04:00:00,10,8,2,Bedeckt,2,-3,0,
,2021-11-23 05:00:00,35,24,11,Bedeckt,2,-3,0,
,2021-11-23 06:00:00,167,95,72,Bedeckt,2,-3,0,
,2021-11-23 07:00:00,999,633,366,Bedeckt,3,-2,0,
,2021-11-23 08:00:00,733,401,332,Bewölkt,3,-1,0,
,2021-11-23 09:00:00,637,382,255,Bewölkt,4,-1,0,
,2021-11-23 10:00:00,394,225,169,Bewölkt,4,1,0,
,2021-11-23 11:00:00,564,290,274,Leicht bewölkt,5,2,0,
,2021-11-23 12:00:00,566,204,362,Leicht bewölkt,6,3,0,
,2021-11-23 13:00:00,828,386,442,Leicht bewölkt,6,3,0,
,2021-11-23 14:00:00,524,255,269,Leicht bewölkt,6,3,0,
,2021-11-23 15:00:00,833,402,431,Leicht bewölkt,6,3,0,
,2021-11-23 16:00:00,777,344,433,Leicht bewölkt,5,2,0,
,2021-11-23 17:00:00,930,449,481,Leicht bewölkt,4,1,0,
,2021-11-23 18:00:00,727,360,367,Leicht bewölkt,3,0,0,
,2021-11-23 19:00:00,531,252,279,Leicht bewölkt,2,-1,0,
,2021-11-23 20:00:00,379,149,230,Sonnig,1,-2,0,
,2021-11-23 21:00:00,242,99,143,Sonnig,0,-3,0,
,2021-11-23 22:00:00,198,73,125,Sonnig,0,-4,0,
,2021-11-23 23:00:00,106,53,53,Leichter Nebel,-1,-4,0,
,2021-11-24 00:00:00,56,20,36,Leichter Nebel,-2,-5,0,
,2021-11-24 01:00:00,35,11,24,Leichter Nebel,-2,-5,0,
,2021-11-24 02:00:00,17,3,14,Leichter Nebel,-2,-5,0,
,2021-11-24 03:00:00,3,2,1,Leichter Nebel,-3,-5,0,
,2021-11-24 04:00:00,6,4,2,Leichter Nebel,-3,-5,0,
,2021-11-24 05:00:00,42,30,12,Leichter Nebel,-3,-5,0,
,2021-11-24 06:00:00,150,86,64,Leichter Nebel,-3,-5,0,
,2021-11-24 07:00:00,978,620,358,Leichter Nebel,-2,-4,0,
,2021-11-24 08:00:00,699,399,300,Bewölkt,-1,-3,0,
,2021-11-24 09:00:00,677,410,267,Bewölkt,0,-1,0,
,2021-11-24 10:00:00,379,211,168,Bewölkt,2,1,0,
,2021-11-24 11:00:00,520,251,269,Leicht bewölkt,3,2,0,
,2021-11-24 12:00:00,542,237,305,Leicht bewölkt,5,4,0,
,2021-11-24 13:00:00,854,437,417,Leicht bewölkt,6,5,0,
,2021-11-24 14:00:00,565,262,303,Sonnig,7,6,0,
,2021-11-24 15:00:00,816,355,461,Sonnig,7,7,0,
,2021-11-24 16:00:00,769,359,410,Sonnig,5,5,0,
,2021-11-24 17:00:00,861,398,463,Sonnig,3,3,0,
,2021-11-24 18:00:00,716,320,396,Sonnig,1,1,0,
,2021-11-24 19:00:00,488,204,284,Sonnig,1,0,0,
,2021-11-24 20:00:00,359,174,185,Sonnig,0,-1,0,
,2021-11-24 21:00:00,224,121,103,Sonnig,-1,-2,0,
,2021-11-24 22:00:00,195,90,105,Sonnig,-1,-2,0,
,2021-11-24 23:00:00,119,49,70,Sonnig,-1,-1,0,
,2021-11-25 00:00:00,58,20,38,Sonnig,-1,-1,0,
,2021-11-25 01:00:00,24,13,11,Sonnig,-1,-1,0,
,2021-11-25 02:00:00,10,2,8,Sonnig,-1,-1,0,
,2021-11-25 03:00:00,8,4,4,Sonnig,-1,-1,0,
,2021-11-25 04:00:00,10,5,5,Sonnig,-1,-1,0,
,2021-11-25 05:00:00,34,23,11,Leicht bewölkt,-1,-1,0,
,2021-11-25 06:00:00,133,81,52,Leicht bewölkt,-1,-1,0,
,2021-11-25 07:00:00,994,668,326,Leicht bewölkt,0,0,0,
,2021-11-25 08:00:00,659,364,295,Sonnig,1,0,0,
,2021-11-25 09:00:00,605,354,251,Sonnig,2,1,0,
,2021-11-25 10:00:00,328,176,152,Sonnig,3,3,0,
,2021-11-25 11:00:00,481,242,239,Leicht bewölkt,5,5,0,
,2021-11-25 12:00:00,520,258,262,Leicht bewölkt,7,7,0,
,2021-11-25 13:00:00,823,381,442,Leicht bewölkt,7,7,0,
,2021-11-25 14:00:00,525,256,269,Leicht bewölkt,7,7,0,
,2021-11-25 15:00:00,886,423,463,Leicht bewölkt,7,7,0,
,2021-11-25 16:00:00,706,339,367,Leicht bewölkt,5,5,0,
,2021-11-25 17:00:00,852,376,476,Bedeckt,3,2,0,
,2021-11-25 18:00:00,679,302,377,Bedeckt,1,0,0,
,2021-11-25 19:00:00,487,218,269,Bedeckt,1,0,0,
,2021-11-25 20:00:00,332,150,182,Bedeckt,1,0,0,
,2021-11-25 21:00:00,201,103,98,Bedeckt,2,0,0,
,2021-11-25 22:00:00,197,95,102,Bedeckt,1,-1,0,
,2021-11-25 23:00:00,118,50,68,Bewölkt,1,-1,0,
,2021-11-26 00:00:00,65,30,35,Bewölkt,1,-1,0,
,2021-11-26 01:00:00,36,10,26,Bewölkt,0,-2,0,
,2021-11-26 02:00:00,19,9,10,Leicht bewölkt,0,-3,0,
,2021-11-26 03:00:00,7,3,4,Leicht bewölkt,-1,-4,0,
,2021-11-26 04:00:00,6,4,2,Leicht bewölkt,-1,-4,0,
,2021-11-26 05:00:00,41,26,15,Bedeckt,-1,-3,0,
,2021-11-26 06:00:00,107,66,41,Bedeckt,-1,-3,0,
,2021-11-26 07:00:00,811,484,327,Bedeckt,0,-2,0,
,2021-11-26 08:00:00,532,301,231,Mäßiger Schneefall,0,-1,0.1,
,2021-11-26 09:00:00,447,270,177,Mäßiger Schneefall,1,0,0.1,
,2021-11-26 10:00:00,322,167,155,Mäßiger Schneefall,1,0,0,
,2021-11-26 11:00:00,392,193,199,Starker Schneefall,1,0,0.1,
,2021-11-26 12:00:00,579,256,323,Starker Schneefall,1,0,0.2,
,2021-11-26 13:00:00,764,317,447,Starker Schneefall,1,0,0.1,
,2021-11-26 14:00:00,551,272,279,Starker Schneefall,1,0,0.1,
,2021-11-26 15:00:00,601,288,313,Starker Schneefall,2,0,0.2,
,2021-11-26 16:00:00,538,280,258,Starker Schneefall,1,-1,0.1,
,2021-11-26 17:00:00,551,260,291,Starker Schneefall,1,-1,0.1,
,2021-11-26 18:00:00,474,229,245,Starker Schneefall,1,-1,0.2,
,2021-11-26 19:00:00,421,227,194,Starker Schneefall,1,-1,0.1,
,2021-11-26 20:00:00,251,120,131,Leichter Nebel,1,-1,0,
,2021-11-26 21:00:00,209,86,123,Leichter Nebel,1,-1,0,
,2021-11-26 22:00:00,185,81,104,Leichter Nebel,0,-1,0,
,2021-11-26 23:00:00,98,44,54,Leichter Schneefall,0,-2,0,
,2021-11-27 00:00:00,104,34,70,Leichter Schneefall,0,-2,0,
,2021-11-27 01:00:00,82,34,48,Leichter Schneefall,0,-2,0,
,2021-11-27 02:00:00,64,19,45,Leichter Nebel,0,-2,0,
,2021-11-27 03:00:00,40,19,21,Leichter Nebel,0,-2,0,
,2021-11-27 04:00:00,29,13,16,Leichter Nebel,-1,-2,0,
,2021-11-27 05:00:00,33,17,16,Leichter Nebel,-2,-3,0,
,2021-11-27 06:00:00,42,24,18,Leichter Nebel,-3,-3,0,
,2021-11-27 07:00:00,57,27,30,Leichter Nebel,-2,-2,0,
,2021-11-27 08:00:00,143,74,69,Leichter Nebel,-2,-2,0,
,2021-11-27 09:00:00,293,177,116,Leichter Nebel,-1,-1,0,
,2021-11-27 10:00:00,380,216,164,Leichter Nebel,0,0,0,
,2021-11-27 11:00:00,370,192,178,Sonnig,1,1,0,
,2021-11-27 12:00:00,457,222,235,Sonnig,2,1,0,
,2021-11-27 13:00:00,406,195,211,Sonnig,2,1,0,
,2021-11-27 14:00:00,390,184,206,Leichter Schneefall,2,1,0.1,
,2021-11-27 15:00:00,372,203,169,Leichter Schneefall,2,1,0.2,
,2021-11-27 16:00:00,394,174,220,Leichter Schneefall,2,0,0.1,
,2021-11-27 17:00:00,368,167,201,Starker Schneefall,2,0,0.3,
,2021-11-27 18:00:00,351,153,198,Starker Schneefall,1,-1,0.4,
,2021-11-27 19:00:00,273,124,149,Starker Schneefall,1,-1,0.2,
,2021-11-27 20:00:00,208,91,117,Starker Schneefall,1,-1,0.3,
,2021-11-27 21:00:00,137,58,79,Starker Schneefall,1,-1,0.4,
,2021-11-27 22:00:00,115,42,73,Starker Schneefall,1,-1,0.2,
,2021-11-27 23:00:00,147,70,77,Leichter Eisregen,1,-1,0.3,
,2021-11-28 00:00:00,93,43,50,Leichter Eisregen,0,-1,0.7,
,2021-11-28 01:00:00,80,28,52,Leichter Eisregen,0,-1,0.3,
,2021-11-28 02:00:00,61,28,33,Starker Schneefall,0,-2,0.2,
,2021-11-28 03:00:00,56,19,37,Starker Schneefall,-1,-2,0.2,
,2021-11-28 04:00:00,19,7,12,Starker Schneefall,-1,-2,0.1,
,2021-11-28 05:00:00,19,6,13,Mäßiger Schneefall,-1,-3,0.2,
,2021-11-28 06:00:00,18,11,7,Mäßiger Schneefall,-1,-3,0.3,
,2021-11-28 07:00:00,33,15,18,Mäßiger Schneefall,0,-2,0.1,
,2021-11-28 08:00:00,65,24,41,Starker Schneefall,1,-2,0.1,
,2021-11-28 09:00:00,101,54,47,Starker Schneefall,1,-1,0.1,
,2021-11-28 10:00:00,167,99,68,Starker Schneefall,2,-1,0.1,
,2021-11-28 11:00:00,164,90,74,Stellenweise leichter Schneefall,2,0,0,
,2021-11-28 12:00:00,209,97,112,Stellenweise leichter Schneefall,3,0,0,
,2021-11-28 13:00:00,230,127,103,Stellenweise leichter Schneefall,2,0,0,
,2021-11-28 14:00:00,280,128,152,Bewölkt,2,0,0,
,2021-11-28 15:00:00,281,131,150,Bewölkt,2,-1,0,
,2021-11-28 16:00:00,233,120,113,Bewölkt,1,-1,0,
,2021-11-28 17:00:00,251,124,127,Leichter Schneefall,0,-2,0,
,2021-11-28 18:00:00,190,100,90,Leichter Schneefall,-1,-3,0,
,2021-11-28 19:00:00,185,95,90,Leichter Schneefall,-1,-3,0,
,2021-11-28 20:00:00,120,55,65,Leichter Nebel,-2,-3,0,
,2021-11-28 21:00:00,88,40,48,Leichter Nebel,-2,-3,0,
,2021-11-28 22:00:00,82,41,41,Leichter Nebel,-2,-3,0,
,2021-11-28 23:00:00,53,17,36,Mäßige bis starke Schneefälle,-2,-4,0.1,
,2021-11-29 00:00:00,28,15,13,Mäßige bis starke Schneefälle,-1,-4,0.1,
,2021-11-29 01:00:00,7,4,3,Mäßige bis starke Schneefälle,-1,-4,0.1,
,2021-11-29 02:00:00,9,4,5,Leichter Schneefall,-2,-4,0,
,2021-11-29 03:00:00,1,1,0,Leichter Schneefall,-2,-4,0,
,2021-11-29 04:00:00,5,3,2,Leichter Schneefall,-2,-4,0,
,2021-11-29 05:00:00,46,27,19,Mäßige bis starke Schneefälle,-1,-4,0,
,2021-11-29 06:00:00,130,71,59,Mäßige bis starke Schneefälle,-1,-3,0,
,2021-11-29 07:00:00,879,553,326,Mäßige bis starke Schneefälle,-1,-3,0,
,2021-11-29 08:00:00,670,381,289,Mäßiger Schneefall,-1,-3,0,
,2021-11-29 09:00:00,577,340,237,Mäßiger Schneefall,-1,-3,0,
,2021-11-29 10:00:00,284,159,125,Mäßiger Schneefall,0,-3,0,
,2021-11-29 11:00:00,449,212,237,Mäßige bis starke Schneefälle,0,-2,0.1,
,2021-11-29 12:00:00,452,185,267,Mäßige bis starke Schneefälle,1,-2,0.1,
,2021-11-29 13:00:00,785,381,404,Mäßige bis starke Schneefälle,1,-2,0.1,
,2021-11-29 14:00:00,493,241,252,Mäßiger Schneefall,1,-2,0.1,
,2021-11-29 15:00:00,834,391,443,Mäßiger Schneefall,1,-2,0.1,
,2021-11-29 16:00:00,651,317,334,Mäßiger Schneefall,0,-3,0,
,2021-11-29 17:00:00,817,350,467,Mäßige bis starke Schneefälle,-1,-4,0.1,
,2021-11-29 18:00:00,594,265,329,Mäßige bis starke Schneefälle,-2,-5,0.1,
,2021-11-29 19:00:00,432,209,223,Mäßige bis starke Schneefälle,-1,-5,0,
,2021-11-29 20:00:00,311,155,156,Mäßige bis starke Schneefälle,-1,-6,0.1,
,2021-11-29 21:00:00,193,82,111,Mäßige bis starke Schneefälle,-1,-6,0.1,
,2021-11-29 22:00:00,127,50,77,Mäßige bis starke Schneefälle,-1,-6,0,
,2021-11-29 23:00:00,90,31,59,Starker Schneefall,-1,-6,0.1,
,2021-11-30 00:00:00,33,14,19,Starker Schneefall,-1,-6,0.2,
,2021-11-30 01:00:00,31,12,19,Starker Schneefall,-1,-6,0.1,
,2021-11-30 02:00:00,10,5,5,Bedeckt,-1,-6,0,
,2021-11-30 03:00:00,3,1,2,Bedeckt,0,-6,0,
,2021-11-30 04:00:00,3,3,0,Bedeckt,0,-6,0,
,2021-11-30 05:00:00,41,24,17,Leichter Schneefall,0,-6,0,
,2021-11-30 06:00:00,128,69,59,Leichter Schneefall,0,-5,0,
,2021-11-30 07:00:00,861,547,314,Leichter Schneefall,0,-5,0,
,2021-11-30 08:00:00,644,343,301,Bewölkt,0,-5,0,
,2021-11-30 09:00:00,631,375,256,Bewölkt,0,-5,0,
,2021-11-30 10:00:00,334,193,141,Bewölkt,1,-4,0,
,2021-11-30 11:00:00,445,220,225,Bedeckt,2,-3,0,
,2021-11-30 12:00:00,526,219,307,Bedeckt,2,-2,0,
,2021-11-30 13:00:00,764,339,425,Bedeckt,2,-2,0,
,2021-11-30 14:00:00,481,233,248,Bedeckt,2,-3,0,
,2021-11-30 15:00:00,812,374,438,Bedeckt,2,-3,0,
,2021-11-30 16:00:00,613,255,358,Bedeckt,2,-3,0,
,2021-11-30 17:00:00,787,341,446,Starker Schneefall,2,-3,0.2,
,2021-11-30 18:00:00,594,267,327,Starker Schneefall,2,-3,0.2,
,2021-11-30 19:00:00,351,159,192,Starker Schneefall,2,-3,0.1,
,2021-11-30 20:00:00,271,130,141,Leichter Eisregen,2,-3,0.3,
,2021-11-30 21:00:00,134,65,69,Leichter Eisregen,2,-3,0.4,
,2021-11-30 22:00:00,109,46,63,Leichter Eisregen,2,-2,0.2,
,2021-11-30 23:00:00,85,31,54,Stellenweiser leichter Regenfall,3,-2,0.3,
,2021-12-01 00:00:00,24,9,15,Stellenweiser leichter Regenfall,3,-1,0.5,
,2021-12-01 01:00:00,27,11,16,Stellenweiser leichter Regenfall,2,-2,0.3,
,2021-12-01 02:00:00,6,3,3,Leicht bewölkt,2,-2,0,
,2021-12-01 03:00:00,5,1,4,Leicht bewölkt,1,-3,0,
,2021-12-01 04:00:00,7,6,1,Leicht bewölkt,1,-3,0,
,2021-12-01 05:00:00,39,23,16,Leicht bewölkt,1,-3,0,
,2021-12-01 06:00:00,127,62,65,Leicht bewölkt,1,-3,0,
,2021-12-01 07:00:00,883,561,322,Leicht bewölkt,1,-3,0,
,2021-12-01 08:00:00,627,341,286,Bewölkt,2,-2,0,
,2021-12-01 09:00:00,615,361,254,Bewölkt,2,-2,0,
,2021-12-01 10:00:00,407,236,171,Bewölkt,3,-1,0,
,2021-12-01 11:00:00,557,261,296,Bedeckt,4,0,0,
,2021-12-01 12:00:00,530,252,278,Bedeckt,5,1,0,
,2021-12-01 13:00:00,843,394,449,Bedeckt,5,2,0,
,2021-12-01 14:00:00,495,246,249,Bewölkt,6,2,0,
,2021-12-01 15:00:00,746,300,446,Bewölkt,6,2,0,
,2021-12-01 16:00:00,594,274,320,Bewölkt,6,2,0,
,2021-12-01 17:00:00,710,337,373,Nieselregen,5,1,0.1,
,2021-12-01 18:00:00,500,226,274,Nieselregen,5,1,0.1,
,2021-12-01 19:00:00,385,192,193,Nieselregen,5,1,0.1,
,2021-12-01 20:00:00,310,155,155,Nieselregen,4,1,0.2,
,2021-12-01 21:00:00,174,71,103,Nieselregen,4,1,0.2,
,2021-12-01 22:00:00,174,75,99,Nieselregen,4,1,0.1,
,2021-12-01 23:00:00,94,36,58,Leichter Regenschauer,4,1,0.1,
,2021-12-02 00:00:00,46,15,31,Leichter Regenschauer,4,1,0.2,
,2021-12-02 01:00:00,38,13,25,Leichter Regenschauer,4,1,0.1,
,2021-12-02 02:00:00,12,5,7,Bedeckt,4,0,0,
,2021-12-02 03:00:00,10,3,7,Bedeckt,4,0,0,
,2021-12-02 04:00:00,5,5,0,Bedeckt,4,0,0,
,2021-12-02 05:00:00,32,18,14,Leichte Eisregen,4,0,0.1,
,2021-12-02 06:00:00,138,71,67,Leichte Eisregen,4,0,0.2,
,2021-12-02 07:00:00,841,563,278,Leichte Eisregen,3,0,0.1,
,2021-12-02 08:00:00,663,372,291,Leichter Eisregen,3,0,0.1,
,2021-12-02 09:00:00,596,335,261,Leichter Eisregen,3,0,0.1,
,2021-12-02 10:00:00,395,214,181,Leichter Eisregen,3,0,0,
,2021-12-02 11:00:00,516,255,261,Mäßige bis starke Schneefälle,3,0,0.1,
,2021-12-02 12:00:00,502,240,262,Mäßige bis starke Schneefälle,3,0,0.1,
,2021-12-02 13:00:00,769,346,423,Mäßige bis starke Schneefälle,3,0,0,
,2021-12-02 14:00:00,555,257,298,Mäßige bis starke Schneefälle,3,0,0,
,2021-12-02 15:00:00,654,283,371,Mäßige bis starke Schneefälle,3,0,0,
,2021-12-02 16:00:00,609,309,300,Mäßige bis starke Schneefälle,2,-1,0,
,2021-12-02 17:00:00,751,323,428,Mäßige bis starke Schneefälle,1,-2,0.1,
,2021-12-02 18:00:00,563,271,292,Mäßige bis starke Schneefälle,0,-3,0.2,
,2021-12-02 19:00:00,433,182,251,Mäßige bis starke Schneefälle,0,-3,0.1,
,2021-12-02 20:00:00,283,120,163,Leichter Schneefall,0,-3,0,
,2021-12-02 21:00:00,154,65,89,Leichter Schneefall,0,-3,0,
,2021-12-02 22:00:00,134,53,81,Leichter Schneefall,-1,-4,0,
,2021-12-02 23:00:00,124,51,73,Mäßige bis starke Schneefälle,-2,-5,0.1,
,2021-12-03 00:00:00,53,23,30,Mäßige bis starke Schneefälle,-3,-7,0.2,
,2021-12-03 01:00:00,35,10,25,Mäßige bis starke Schneefälle,-3,-6,0.1,
,2021-12-03 02:00:00,18,7,11,Leicht bewölkt,-3,-6,0,
,2021-12-03 03:00:00,10,4,6,Leicht bewölkt,-3,-6,0,
,2021-12-03 04:00:00,6,5,1,Leicht bewölkt,-3,-6,0,
,2021-12-03 05:00:00,31,19,12,Stellenweise leichter Schneefall,-3,-6,0,
,2021-12-03 06:00:00,119,62,57,Stellenweise leichter Schneefall,-4,-6,0,
,2021-12-03 07:00:00,810,506,304,Stellenweise leichter Schneefall,-4,-6,0,
,2021-12-03 08:00:00,543,292,251,Sonnig,-4,-6,0,
,2021-12-03 09:00:00,543,341,202,Sonnig,-4,-7,0,
,2021-12-03 10:00:00,448,265,183,Sonnig,-2,-5,0,
,2021-12-03 11:00:00,526,266,260,Sonnig,-1,-4,0,
,2021-12-03 12:00:00,658,283,375,Sonnig,1,-2,0,
,2021-12-03 13:00:00,908,335,573,Sonnig,1,-1,0,
,2021-12-03 14:00:00,576,276,300,Sonnig,1,-1,0,
,2021-12-03 15:00:00,667,296,371,Sonnig,1,0,0,
,2021-12-03 16:00:00,611,278,333,Sonnig,0,-2,0,
,2021-12-03 17:00:00,625,318,307,Sonnig,-2,-4,0,
,2021-12-03 18:00:00,477,221,256,Sonnig,-4,-5,0,
,2021-12-03 19:00:00,385,189,196,Sonnig,-4,-6,0,
,2021-12-03 20:00:00,285,146,139,Sonnig,-4,-7,0,
,2021-12-03 21:00:00,205,97,108,Sonnig,-5,-8,0,
,2021-12-03 22:00:00,154,64,90,Sonnig,-4,-7,0,
,2021-12-03 23:00:00,144,59,85,Bedeckt,-3,-6,0,
,2021-12-04 00:00:00,135,50,85,Bedeckt,-2,-4,0,
,2021-12-04 01:00:00,91,29,62,Bedeckt,-1,-4,0,
,2021-12-04 02:00:00,52,25,27,Bedeckt,-1,-4,0,
,2021-12-04 03:00:00,50,12,38,Bedeckt,0,-4,0,
,2021-12-04 04:00:00,18,11,7,Bedeckt,0,-3,0,
,2021-12-04 05:00:00,24,13,11,Leichter Eisregen,1,-3,0.4,
,2021-12-04 06:00:00,34,19,15,Leichter Eisregen,1,-2,0.5,
,2021-12-04 07:00:00,38,21,17,Leichter Eisregen,1,-2,0.2,
,2021-12-04 08:00:00,100,66,34,Leichter Regenfall,2,-2,0.4,
,2021-12-04 09:00:00,148,82,66,Leichter Regenfall,2,-2,0.5,
,2021-12-04 10:00:00,225,133,92,Leichter Regenfall,2,-1,0.2,
,2021-12-04 11:00:00,307,155,152,Leichter Regenfall,3,-1,0.4,
,2021-12-04 12:00:00,322,181,141,Leichter Regenfall,3,0,0.5,
,2021-12-04 13:00:00,239,117,122,Leichter Regenfall,4,1,0.2,
,2021-12-04 14:00:00,242,104,138,Stellenweiser Regenfall,5,1,0,
,2021-12-04 15:00:00,235,120,115,Stellenweiser Regenfall,6,2,0,
,2021-12-04 16:00:00,248,116,132,Stellenweiser Regenfall,6,2,0,
,2021-12-04 17:00:00,246,110,136,Leichter Regenfall,6,2,0.3,
,2021-12-04 18:00:00,254,121,133,Leichter Regenfall,6,2,0.4,
,2021-12-04 19:00:00,148,72,76,Leichter Regenfall,5,2,0.2,
,2021-12-04 20:00:00,171,70,101,Nieselregen,4,1,0.2,
,2021-12-04 21:00:00,95,46,49,Nieselregen,4,1,0.2,
,2021-12-04 22:00:00,76,33,43,Nieselregen,4,0,0.1,
,2021-12-04 23:00:00,73,28,45,Mäßige bis starke Schneefälle,3,-1,0.1,
,2021-12-05 00:00:00,49,27,22,Mäßige bis starke Schneefälle,3,-2,0.2,
,2021-12-05 01:00:00,68,27,41,Mäßige bis starke Schneefälle,3,-2,0.1,
,2021-12-05 02:00:00,51,22,29,Mäßige bis starke Schneefälle,2,-2,0,
,2021-12-05 03:00:00,40,13,27,Mäßige bis starke Schneefälle,2,-2,0,
,2021-12-05 04:00:00,23,12,11,Mäßige bis starke Schneefälle,2,-2,0,
,2021-12-05 05:00:00,18,6,12,Mäßige bis starke Schneefälle,1,-2,0,
,2021-12-05 06:00:00,26,17,9,Mäßige bis starke Schneefälle,1,-2,0,
,2021-12-05 07:00:00,32,15,17,Mäßige bis starke Schneefälle,1,-2,0,
,2021-12-05 08:00:00,52,28,24,Leichter Schneefall,1,-2,0,
,2021-12-05 09:00:00,128,64,64,Leichter Schneefall,1,-2,0,
,2021-12-05 10:00:00,166,75,91,Leichter Schneefall,2,-1,0,
,2021-12-05 11:00:00,233,118,115,Leichte Schneeschauer,3,0,0,
,2021-12-05 12:00:00,282,123,159,Leichte Schneeschauer,4,1,0,
,2021-12-05 13:00:00,294,159,135,Leichte Schneeschauer,3,1,0,
,2021-12-05 14:00:00,375,219,156,Bewölkt,3,1,0,
,2021-12-05 15:00:00,271,128,143,Bewölkt,3,1,0,
,2021-12-05 16:00:00,282,121,161,Bewölkt,2,-1,0,
,2021-12-05 17:00:00,295,107,188,Leichte Schneeschauer,0,-2,0,
,2021-12-05 18:00:00,210,104,106,Leichte Schneeschauer,-2,-3,0,
,2021-12-05 19:00:00,179,99,80,Leichte Schneeschauer,-1,-3,0,
,2021-12-05 20:00:00,128,72,56,Mäßiger Schneefall,-1,-3,0,
,2021-12-05 21:00:00,76,38,38,Mäßiger Schneefall,-1,-3,0,
,2021-12-05 22:00:00,62,32,30,Mäßiger Schneefall,-1,-4,0,
,2021-12-05 23:00:00,45,24,21,Leichter Schneefall,-2,-4,0,
,2021-12-06 00:00:00,30,20,10,Leichter Schneefall,-2,-5,0.1,
,2021-12-06 01:00:00,15,8,7,Leichter Schneefall,-2,-5,0,
,2021-12-06 02:00:00,7,2,5,Mäßiger Schneefall,-2,-5,0.1,
,2021-12-06 03:00:00,1,1,0,Mäßiger Schneefall,-2,-5,0.1,
,2021-12-06 04:00:00,5,3,2,Mäßiger Schneefall,-2,-5,0,
,2021-12-06 05:00:00,32,16,16,Starker Schneefall,-2,-5,0.1,
,2021-12-06 06:00:00,142,80,62,Starker Schneefall,-2,-6,0.2,
,2021-12-06 07:00:00,874,525,349,Starker Schneefall,-1,-5,0.1,
,2021-12-06 08:00:00,629,331,298,Starker Schneefall,-1,-4,0.2,
,2021-12-06 09:00:00,565,347,218,Starker Schneefall,0,-3,0.3,
,2021-12-06 10:00:00,327,181,146,Starker Schneefall,0,-3,0.2,
,2021-12-06 11:00:00,492,231,261,Starker Schneefall,1,-2,0.2,
,2021-12-06 12:00:00,515,239,276,Starker Schneefall,1,-2,0.3,
,2021-12-06 13:00:00,835,382,453,Starker Schneefall,1,-2,0.2,
,2021-12-06 14:00:00,558,299,259,Mäßige bis starke Schneefälle,2,-2,0.1,
,2021-12-06 15:00:00,831,359,472,Mäßige bis starke Schneefälle,2,-2,0.1,
,2021-12-06 16:00:00,693,313,380,Mäßige bis starke Schneefälle,1,-3,0,
,2021-12-06 17:00:00,792,326,466,Mäßige bis starke Schneefälle,0,-4,0,
,2021-12-06 18:00:00,587,265,322,Mäßige bis starke Schneefälle,-1,-5,0,
,2021-12-06 19:00:00,442,191,251,Mäßige bis starke Schneefälle,-2,-4,0,
,2021-12-06 20:00:00,289,132,157,Bewölkt,-3,-4,0,
,2021-12-06 21:00:00,184,93,91,Bewölkt,-3,-3,0,
,2021-12-06 22:00:00,124,62,62,Bewölkt,-3,-4,0,
,2021-12-06 23:00:00,70,23,47,Leicht bewölkt,-2,-5,0,
,2021-12-07 00:00:00,38,21,17,Leicht bewölkt,-2,-5,0,
,2021-12-07 01:00:00,20,9,11,Leicht bewölkt,-1,-5,0,
,2021-12-07 02:00:00,7,2,5,Starker Schneefall,0,-5,0.2,
,2021-12-07 03:00:00,4,3,1,Starker Schneefall,1,-5,0.2,
,2021-12-07 04:00:00,6,3,3,Starker Schneefall,1,-4,0.1,
,2021-12-07 05:00:00,32,19,13,Starker Schneefall,1,-4,0.2,
,2021-12-07 06:00:00,158,92,66,Starker Schneefall,2,-3,0.3,
,2021-12-07 07:00:00,881,554,327,Starker Schneefall,2,-3,0.1,
,2021-12-07 08:00:00,672,348,324,Leichter Schneefall,2,-3,0,
,2021-12-07 09:00:00,604,377,227,Leichter Schneefall,2,-3,0,
,2021-12-07 10:00:00,333,190,143,Leichter Schneefall,2,-2,0,
,2021-12-07 11:00:00,494,261,233,Mäßige bis starke Schneefälle,2,-1,0,
,2021-12-07 12:00:00,541,243,298,Mäßige bis starke Schneefälle,3,-1,0,
,2021-12-07 13:00:00,865,404,461,Mäßige bis starke Schneefälle,3,-1,0,
,2021-12-07 14:00:00,512,249,263,Stellenweise leichter Schneefall,3,0,0,
,2021-12-07 15:00:00,816,385,431,Stellenweise leichter Schneefall,2,0,0,
,2021-12-07 16:00:00,774,319,455,Stellenweise leichter Schneefall,0,-2,0,
,2021-12-07 17:00:00,848,381,467,Leichte Schneeschauer,-2,-4,0,
,2021-12-07 18:00:00,633,295,338,Leichte Schneeschauer,-4,-5,0,
,2021-12-07 19:00:00,471,205,266,Leichte Schneeschauer,-4,-6,0,
,2021-12-07 20:00:00,324,136,188,Leicht bewölkt,-5,-7,0,
,2021-12-07 21:00:00,186,97,89,Leicht bewölkt,-5,-8,0,
,2021-12-07 22:00:00,130,52,78,Leicht bewölkt,-5,-7,0,
,2021-12-07 23:00:00,91,40,51,Bedeckt,-4,-5,0,
,2021-12-08 00:00:00,47,20,27,Bedeckt,-4,-4,0,
,2021-12-08 01:00:00,42,21,21,Bedeckt,-3,-3,0,
,2021-12-08 02:00:00,10,4,6,Stellenweise mäßiger Schneefall,-2,-2,0.1,
,2021-12-08 03:00:00,2,0,2,Stellenweise mäßiger Schneefall,-2,-2,0.1,
,2021-12-08 04:00:00,10,6,4,Stellenweise mäßiger Schneefall,-1,-2,0,
,2021-12-08 05:00:00,32,16,16,Stellenweise mäßiger Schneefall,-1,-2,0.1,
,2021-12-08 06:00:00,139,78,61,Stellenweise mäßiger Schneefall,0,-2,0.1,
,2021-12-08 07:00:00,726,450,276,Stellenweise mäßiger Schneefall,0,-1,0,
,2021-12-08 08:00:00,481,247,234,Stellenweise starker Schneefall,0,-1,0.1,
,2021-12-08 09:00:00,432,249,183,Stellenweise starker Schneefall,0,-1,0.1,
,2021-12-08 10:00:00,233,128,105,Stellenweise starker Schneefall,0,-1,0.1,
,2021-12-08 11:00:00,344,145,199,Starker Schneefall,1,0,0.2,
,2021-12-08 12:00:00,350,179,171,Starker Schneefall,1,0,0.2,
,2021-12-08 13:00:00,612,293,319,Starker Schneefall,1,0,0.1,
,2021-12-08 14:00:00,297,152,145,Starker Schneefall,1,0,0.1,
,2021-12-08 15:00:00,524,204,320,Starker Schneefall,1,1,0.1,
,2021-12-08 16:00:00,400,194,206,Starker Schneefall,1,0,0.1,
,2021-12-08 17:00:00,457,218,239,Starker Schneefall,1,0,0.2,
,2021-12-08 18:00:00,387,164,223,Starker Schneefall,1,0,0.3,
,2021-12-08 19:00:00,295,132,163,Starker Schneefall,1,-1,0.2,
,2021-12-08 20:00:00,223,117,106,Starker Schneefall,1,-1,0.1,
,2021-12-08 21:00:00,147,60,87,Starker Schneefall,1,-2,0.1,
,2021-12-08 22:00:00,84,36,48,Starker Schneefall,1,-2,0.1,
,2021-12-08 23:00:00,77,30,47,Mäßige bis starke Schneefälle,1,-1,0.1,
,2021-12-09 00:00:00,49,19,30,Mäßige bis starke Schneefälle,1,-1,0.1,
,2021-12-09 01:00:00,25,8,17,Mäßige bis starke Schneefälle,1,-1,0.1,
,2021-12-09 02:00:00,15,5,10,Leichter Nebel,1,-1,0,
,2021-12-09 03:00:00,4,1,3,Leichter Nebel,1,-1,0,
,2021-12-09 04:00:00,7,2,5,Leichter Nebel,0,-2,0,
,2021-12-09 05:00:00,37,23,14,Mäßige bis starke Schneefälle,0,-2,0,
,2021-12-09 06:00:00,122,71,51,Mäßige bis starke Schneefälle,-1,-3,0,
,2021-12-09 07:00:00,741,475,266,Mäßige bis starke Schneefälle,-1,-2,0,
,2021-12-09 08:00:00,581,320,261,Leichter Schneefall,0,-2,0,
,2021-12-09 09:00:00,491,290,201,Leichter Schneefall,0,-1,0,
,2021-12-09 10:00:00,324,175,149,Leichter Schneefall,1,-1,0,
,2021-12-09 11:00:00,461,212,249,Mäßige bis starke Schneefälle,1,-1,0,
,2021-12-09 12:00:00,410,176,234,Mäßige bis starke Schneefälle,2,-2,0,
,2021-12-09 13:00:00,719,314,405,Mäßige bis starke Schneefälle,2,-2,0,
,2021-12-09 14:00:00,452,240,212,Leicht bewölkt,2,-2,0,
,2021-12-09 15:00:00,796,396,400,Leicht bewölkt,2,-2,0,
,2021-12-09 16:00:00,632,355,277,Leicht bewölkt,0,-3,0,
,2021-12-09 17:00:00,704,299,405,Leicht bewölkt,-3,-5,0,
,2021-12-09 18:00:00,605,286,319,Leicht bewölkt,-5,-6,0,
,2021-12-09 19:00:00,416,187,229,Leicht bewölkt,-5,-7,0,
,2021-12-09 20:00:00,313,137,176,Leicht bewölkt,-6,-8,0,
,2021-12-09 21:00:00,206,98,108,Leicht bewölkt,-7,-10,0,
,2021-12-09 22:00:00,129,49,80,Leicht bewölkt,-7,-9,0,
,2021-12-09 23:00:00,103,48,55,Leicht bewölkt,-7,-8,0,
,2021-12-10 00:00:00,52,21,31,Leicht bewölkt,-7,-7,0,
,2021-12-10 01:00:00,29,13,16,Leicht bewölkt,-8,-9,0,
,2021-12-10 02:00:00,13,6,7,Leicht bewölkt,-9,-11,0,
,2021-12-10 03:00:00,15,9,6,Leicht bewölkt,-9,-12,0,
,2021-12-10 04:00:00,12,5,7,Leicht bewölkt,-10,-13,0,
,2021-12-10 05:00:00,22,12,10,Leicht bewölkt,-11,-14,0,
,2021-12-10 06:00:00,119,69,50,Leicht bewölkt,-12,-15,0,
,2021-12-10 07:00:00,679,415,264,Leicht bewölkt,-11,-13,0,
,2021-12-10 08:00:00,492,275,217,Bedeckt,-10,-11,0,
,2021-12-10 09:00:00,518,319,199,Bedeckt,-9,-9,0,
,2021-12-10 10:00:00,359,206,153,Bedeckt,-7,-8,0,
,2021-12-10 11:00:00,456,228,228,Bedeckt,-5,-7,0,
,2021-12-10 12:00:00,576,262,314,Bedeckt,-3,-6,0,
,2021-12-10 13:00:00,706,262,444,Bedeckt,-3,-5,0,
,2021-12-10 14:00:00,372,182,190,Mäßiger Schneefall,-3,-4,0,
,2021-12-10 15:00:00,414,175,239,Mäßiger Schneefall,-2,-4,0,
,2021-12-10 16:00:00,395,212,183,Mäßiger Schneefall,-1,-3,0,
,2021-12-10 17:00:00,421,216,205,Starker Schneefall,1,-3,0.1,
,2021-12-10 18:00:00,353,142,211,Starker Schneefall,2,-3,0.1,
,2021-12-10 19:00:00,306,145,161,Starker Schneefall,2,-3,0.1,
,2021-12-10 20:00:00,206,108,98,Bedeckt,1,-3,0,
,2021-12-10 21:00:00,161,75,86,Bedeckt,1,-4,0,
,2021-12-10 22:00:00,118,56,62,Bedeckt,1,-4,0,
,2021-12-10 23:00:00,102,48,54,Mäßiger Schneefall,1,-4,0.1,
,2021-12-11 00:00:00,99,45,54,Mäßiger Schneefall,2,-4,0.1,
,2021-12-11 01:00:00,73,29,44,Mäßiger Schneefall,1,-4,0.1,
,2021-12-11 02:00:00,54,15,39,Bedeckt,1,-4,0,
,2021-12-11 03:00:00,29,5,24,Bedeckt,1,-4,0,
,2021-12-11 04:00:00,20,12,8,Bedeckt,1,-4,0,
,2021-12-11 05:00:00,25,16,9,Mäßiger Schneefall,1,-5,0,
,2021-12-11 06:00:00,49,28,21,Mäßiger Schneefall,1,-5,0,
,2021-12-11 07:00:00,41,26,15,Mäßiger Schneefall,1,-5,0,
,2021-12-11 08:00:00,104,52,52,Bedeckt,1,-5,0,
,2021-12-11 09:00:00,215,118,97,Bedeckt,1,-5,0,
,2021-12-11 10:00:00,290,182,108,Bedeckt,1,-4,0,
,2021-12-11 11:00:00,329,194,135,Starker Schneefall,1,-4,0.1,
,2021-12-11 12:00:00,343,174,169,Starker Schneefall,2,-4,0.1,
,2021-12-11 13:00:00,373,205,168,Starker Schneefall,2,-3,0.1,
,2021-12-11 14:00:00,384,190,194,Leicht bewölkt,2,-2,0,
,2021-12-11 15:00:00,386,187,199,Leicht bewölkt,2,-2,0,
,2021-12-11 16:00:00,314,148,166,Leicht bewölkt,1,-3,0,
,2021-12-11 17:00:00,320,144,176,Sonnig,0,-4,0,
,2021-12-11 18:00:00,287,100,187,Sonnig,-2,-5,0,
,2021-12-11 19:00:00,267,147,120,Sonnig,-2,-5,0,
,2021-12-11 20:00:00,212,110,102,Bedeckt,-2,-5,0,
,2021-12-11 21:00:00,140,71,69,Bedeckt,-2,-5,0,
,2021-12-11 22:00:00,142,43,99,Bedeckt,-1,-4,0,
,2021-12-11 23:00:00,132,55,77,Leichter Schneefall,-1,-4,0,
,2021-12-12 00:00:00,104,42,62,Leichter Schneefall,0,-3,0,
,2021-12-12 01:00:00,82,38,44,Leichter Schneefall,0,-3,0,
,2021-12-12 02:00:00,52,26,26,Leichter Nebel,-1,-3,0,
,2021-12-12 03:00:00,42,15,27,Leichter Nebel,-1,-3,0,
,2021-12-12 04:00:00,12,4,8,Leichter Nebel,-1,-4,0,
,2021-12-12 05:00:00,17,9,8,Leichter Schneefall,-2,-4,0,
,2021-12-12 06:00:00,16,12,4,Leichter Schneefall,-2,-5,0,
,2021-12-12 07:00:00,33,16,17,Leichter Schneefall,-2,-5,0,
,2021-12-12 08:00:00,48,20,28,Leichter Nebel,-3,-6,0,
,2021-12-12 09:00:00,107,68,39,Leichter Nebel,-3,-6,0,
,2021-12-12 10:00:00,168,90,78,Leichter Nebel,-2,-4,0,
,2021-12-12 11:00:00,205,110,95,Leicht bewölkt,0,-3,0,
,2021-12-12 12:00:00,228,114,114,Leicht bewölkt,1,-1,0,
,2021-12-12 13:00:00,255,125,130,Leicht bewölkt,1,0,0,
,2021-12-12 14:00:00,227,106,121,Bewölkt,2,0,0,
,2021-12-12 15:00:00,237,114,123,Bewölkt,2,1,0,
,2021-12-12 16:00:00,259,127,132,Bewölkt,2,1,0,
,2021-12-12 17:00:00,218,104,114,Mäßiger Schneefall,1,0,0.1,
,2021-12-12 18:00:00,202,93,109,Mäßiger Schneefall,1,0,0.1,
,2021-12-12 19:00:00,151,74,77,Mäßiger Schneefall,1,0,0,
,2021-12-12 20:00:00,111,49,62,Nieselregen,1,0,0.1,
,2021-12-12 21:00:00,78,38,40,Nieselregen,2,0,0.2,
,2021-12-12 22:00:00,52,29,23,Nieselregen,1,0,0.1,
,2021-12-12 23:00:00,45,20,25,Leicht bewölkt,0,0,0,
,2021-12-13 00:00:00,17,8,9,Leicht bewölkt,0,0,0,
,2021-12-13 01:00:00,11,7,4,Leicht bewölkt,-1,-1,0,
,2021-12-13 02:00:00,6,3,3,Sonnig,-1,-1,0,
,2021-12-13 03:00:00,3,1,2,Sonnig,-1,-2,0,
,2021-12-13 04:00:00,3,2,1,Sonnig,-1,-2,0,
,2021-12-13 05:00:00,38,24,14,Leicht bewölkt,-2,-2,0,
,2021-12-13 06:00:00,130,70,60,Leicht bewölkt,-2,-2,0,
,2021-12-13 07:00:00,819,507,312,Leicht bewölkt,-2,-2,0,
,2021-12-13 08:00:00,615,340,275,Leicht bewölkt,-2,-2,0,
,2021-12-13 09:00:00,591,360,231,Leicht bewölkt,-2,-2,0,
,2021-12-13 10:00:00,338,189,149,Leicht bewölkt,0,0,0,
,2021-12-13 11:00:00,520,267,253,Leicht bewölkt,2,2,0,
,2021-12-13 12:00:00,482,202,280,Leicht bewölkt,3,3,0,
,2021-12-13 13:00:00,847,354,493,Leicht bewölkt,3,3,0,
,2021-12-13 14:00:00,557,286,271,Sonnig,3,3,0,
,2021-12-13 15:00:00,845,427,418,Sonnig,3,3,0,
,2021-12-13 16:00:00,720,334,386,Sonnig,2,2,0,
,2021-12-13 17:00:00,760,314,446,Leichter Nebel,1,1,0,
,2021-12-13 18:00:00,598,272,326,Leichter Nebel,0,0,0,
,2021-12-13 19:00:00,441,191,250,Leichter Nebel,0,0,0,
,2021-12-13 20:00:00,294,139,155,Leichter Nebel,-1,-1,0,
,2021-12-13 21:00:00,186,90,96,Leichter Nebel,-1,-2,0,
,2021-12-13 22:00:00,117,72,45,Leichter Nebel,-1,-1,0,
,2021-12-13 23:00:00,79,40,39,Nebel,0,0,0,
,2021-12-14 00:00:00,53,35,18,Nebel,0,0,0,
,2021-12-14 01:00:00,24,11,13,Nebel,0,0,0,
,2021-12-14 02:00:00,8,4,4,Nebel,0,0,0,
,2021-12-14 03:00:00,5,3,2,Nebel,0,0,0,
,2021-12-14 04:00:00,5,5,0,Nebel,0,0,0,
,2021-12-14 05:00:00,39,25,14,Leichter Nebel,1,0,0,
,2021-12-14 06:00:00,144,81,63,Leichter Nebel,1,0,0,
,2021-12-14 07:00:00,853,540,313,Leichter Nebel,1,0,0,
,2021-12-14 08:00:00,633,333,300,Leicht bewölkt,1,1,0,
,2021-12-14 09:00:00,566,350,216,Leicht bewölkt,1,1,0,
,2021-12-14 10:00:00,360,211,149,Leicht bewölkt,2,2,0,
,2021-12-14 11:00:00,492,253,239,Bedeckt,3,3,0,
,2021-12-14 12:00:00,584,255,329,Bedeckt,4,4,0,
,2021-12-14 13:00:00,742,329,413,Bedeckt,4,4,0,
,2021-12-14 14:00:00,530,273,257,Leichter Nebel,4,3,0,
,2021-12-14 15:00:00,840,405,435,Leichter Nebel,4,3,0,
,2021-12-14 16:00:00,723,289,434,Leichter Nebel,3,2,0,
,2021-12-14 17:00:00,862,384,478,Leichter Nebel,2,2,0,
,2021-12-14 18:00:00,698,328,370,Leichter Nebel,2,1,0,
,2021-12-14 19:00:00,410,171,239,Leichter Nebel,1,1,0,
,2021-12-14 20:00:00,333,170,163,Nebel,1,1,0,
,2021-12-14 21:00:00,185,91,94,Nebel,1,1,0,
,2021-12-14 22:00:00,168,86,82,Nebel,0,0,0,
,2021-12-14 23:00:00,109,46,63,Leichter Nebel,0,0,0,
,2021-12-15 00:00:00,56,29,27,Leichter Nebel,0,0,0,
,2021-12-15 01:00:00,35,5,30,Leichter Nebel,0,0,0,
,2021-12-15 02:00:00,16,9,7,Leichter Nebel,0,0,0,
,2021-12-15 03:00:00,3,2,1,Leichter Nebel,-1,-1,0,
,2021-12-15 04:00:00,7,3,4,Leichter Nebel,-1,-1,0,
,2021-12-15 05:00:00,37,26,11,Leichter Nebel,-1,-1,0,
,2021-12-15 06:00:00,134,69,65,Leichter Nebel,-1,-1,0,
,2021-12-15 07:00:00,866,545,321,Leichter Nebel,0,0,0,
,2021-12-15 08:00:00,652,387,265,Leicht bewölkt,0,0,0,
,2021-12-15 09:00:00,560,353,207,Leicht bewölkt,0,0,0,
,2021-12-15 10:00:00,357,187,170,Leicht bewölkt,2,2,0,
,2021-12-15 11:00:00,462,224,238,Sonnig,4,4,0,
,2021-12-15 12:00:00,570,276,294,Sonnig,5,5,0,
,2021-12-15 13:00:00,820,437,383,Sonnig,5,5,0,
,2021-12-15 14:00:00,524,250,274,Sonnig,6,6,0,
,2021-12-15 15:00:00,767,330,437,Sonnig,6,6,0,
,2021-12-15 16:00:00,716,317,399,Sonnig,5,5,0,
,2021-12-15 17:00:00,765,336,429,Leichter Nebel,3,3,0,
,2021-12-15 18:00:00,621,264,357,Leichter Nebel,2,2,0,
,2021-12-15 19:00:00,491,237,254,Leichter Nebel,2,2,0,
,2021-12-15 20:00:00,328,179,149,Leichter Nebel,1,1,0,
,2021-12-15 21:00:00,203,86,117,Leichter Nebel,1,1,0,
,2021-12-15 22:00:00,169,68,101,Leichter Nebel,2,2,0,
,2021-12-15 23:00:00,127,55,72,Bewölkt,2,2,0,
,2021-12-16 00:00:00,69,16,53,Bewölkt,3,3,0,
,2021-12-16 01:00:00,43,16,27,Bewölkt,3,3,0,
,2021-12-16 02:00:00,11,4,7,Bewölkt,3,2,0,
,2021-12-16 03:00:00,10,5,5,Bewölkt,2,2,0,
,2021-12-16 04:00:00,11,4,7,Bewölkt,2,2,0,
,2021-12-16 05:00:00,41,29,12,Bewölkt,2,1,0,
,2021-12-16 06:00:00,138,78,60,Bewölkt,2,1,0,
,2021-12-16 07:00:00,899,561,338,Bewölkt,2,0,0,
,2021-12-16 08:00:00,633,343,290,Bewölkt,2,0,0,
,2021-12-16 09:00:00,590,331,259,Bewölkt,1,0,0,
,2021-12-16 10:00:00,386,220,166,Bewölkt,3,1,0,
,2021-12-16 11:00:00,480,247,233,Bewölkt,4,2,0,
,2021-12-16 12:00:00,566,278,288,Bewölkt,5,3,0,
,2021-12-16 13:00:00,790,352,438,Bewölkt,5,3,0,
,2021-12-16 14:00:00,552,267,285,Bewölkt,5,3,0,
,2021-12-16 15:00:00,810,408,402,Bewölkt,6,3,0,
,2021-12-16 16:00:00,726,343,383,Bewölkt,4,2,0,
,2021-12-16 17:00:00,850,395,455,Sonnig,3,0,0,
,2021-12-16 18:00:00,635,306,329,Sonnig,2,-1,0,
,2021-12-16 19:00:00,451,208,243,Sonnig,1,-1,0,
,2021-12-16 20:00:00,328,158,170,Sonnig,0,-1,0,
,2021-12-16 21:00:00,204,107,97,Sonnig,0,-2,0,
,2021-12-16 22:00:00,168,62,106,Sonnig,0,-2,0,
,2021-12-16 23:00:00,108,31,77,Sonnig,0,-2,0,
,2021-12-17 00:00:00,62,19,43,Sonnig,0,-2,0,
,2021-12-17 01:00:00,45,12,33,Sonnig,0,-3,0,
,2021-12-17 02:00:00,30,14,16,Sonnig,0,-3,0,
,2021-12-17 03:00:00,18,3,15,Sonnig,-1,-4,0,
,2021-12-17 04:00:00,12,4,8,Sonnig,-1,-4,0,
,2021-12-17 05:00:00,39,24,15,Sonnig,-1,-4,0,
,2021-12-17 06:00:00,132,84,48,Sonnig,-1,-4,0,
,2021-12-17 07:00:00,770,474,296,Sonnig,-1,-3,0,
,2021-12-17 08:00:00,578,327,251,Sonnig,-1,-3,0,
,2021-12-17 09:00:00,562,329,233,Sonnig,-1,-2,0,
,2021-12-17 10:00:00,426,242,184,Sonnig,1,0,0,
,2021-12-17 11:00:00,585,294,291,Sonnig,3,3,0,
,2021-12-17 12:00:00,659,314,345,Sonnig,6,5,0,
,2021-12-17 13:00:00,830,314,516,Sonnig,6,5,0,
,2021-12-17 14:00:00,598,309,289,Sonnig,6,6,0,
,2021-12-17 15:00:00,712,339,373,Sonnig,6,6,0,
,2021-12-17 16:00:00,591,284,307,Sonnig,4,4,0,
,2021-12-17 17:00:00,633,320,313,Sonnig,2,2,0,
,2021-12-17 18:00:00,535,243,292,Sonnig,0,0,0,
,2021-12-17 19:00:00,440,217,223,Sonnig,0,-1,0,
,2021-12-17 20:00:00,310,159,151,Sonnig,-1,-1,0,
,2021-12-17 21:00:00,206,89,117,Sonnig,-1,-1,0,
,2021-12-17 22:00:00,175,75,100,Sonnig,-1,-2,0,
,2021-12-17 23:00:00,140,59,81,Sonnig,-2,-3,0,
,2021-12-18 00:00:00,112,42,70,Sonnig,-2,-3,0,
,2021-12-18 01:00:00,87,29,58,Sonnig,-2,-3,0,
,2021-12-18 02:00:00,76,16,60,Sonnig,-2,-4,0,
,2021-12-18 03:00:00,61,22,39,Sonnig,-2,-4,0,
,2021-12-18 04:00:00,27,13,14,Sonnig,-2,-4,0,
,2021-12-18 05:00:00,32,12,20,Sonnig,-2,-4,0,
,2021-12-18 06:00:00,45,22,23,Sonnig,-1,-4,0,
,2021-12-18 07:00:00,63,33,30,Sonnig,-1,-4,0,
,2021-12-18 08:00:00,134,78,56,Sonnig,-1,-3,0,
,2021-12-18 09:00:00,255,152,103,Sonnig,-1,-3,0,
,2021-12-18 10:00:00,402,257,145,Sonnig,1,-2,0,
,2021-12-18 11:00:00,439,237,202,Sonnig,3,0,0,
,2021-12-18 12:00:00,470,250,220,Sonnig,5,2,0,
,2021-12-18 13:00:00,471,264,207,Sonnig,6,3,0,
,2021-12-18 14:00:00,485,217,268,Sonnig,7,4,0,
,2021-12-18 15:00:00,559,299,260,Sonnig,8,5,0,
,2021-12-18 16:00:00,470,212,258,Sonnig,5,3,0,
,2021-12-18 17:00:00,451,165,286,Sonnig,3,0,0,
,2021-12-18 18:00:00,357,172,185,Sonnig,1,-2,0,
,2021-12-18 19:00:00,278,158,120,Sonnig,0,-3,0,
,2021-12-18 20:00:00,202,99,103,Sonnig,-1,-4,0,
,2021-12-18 21:00:00,164,90,74,Sonnig,-2,-4,0,
,2021-12-18 22:00:00,118,47,71,Sonnig,-2,-4,0,
,2021-12-18 23:00:00,141,52,89,Sonnig,-3,-3,0,
,2021-12-19 00:00:00,107,43,64,Sonnig,-3,-3,0,
,2021-12-19 01:00:00,93,34,59,Sonnig,-3,-3,0,
,2021-12-19 02:00:00,72,35,37,Sonnig,-3,-3,0,
,2021-12-19 03:00:00,55,9,46,Sonnig,-4,-4,0,
,2021-12-19 04:00:00,22,7,15,Sonnig,-3,-3,0,
,2021-12-19 05:00:00,18,4,14,Sonnig,-3,-3,0,
,2021-12-19 06:00:00,24,16,8,Sonnig,-2,-2,0,
,2021-12-19 07:00:00,34,14,20,Sonnig,-2,-2,0,
,2021-12-19 08:00:00,47,15,32,Sonnig,-2,-2,0,
,2021-12-19 09:00:00,108,57,51,Sonnig,-2,-2,0,
,2021-12-19 10:00:00,130,70,60,Sonnig,0,0,0,
,2021-12-19 11:00:00,177,91,86,Sonnig,3,3,0,
,2021-12-19 12:00:00,185,82,103,Sonnig,5,5,0,
,2021-12-19 13:00:00,239,125,114,Sonnig,5,5,0,
,2021-12-19 14:00:00,252,139,113,Sonnig,6,6,0,
,2021-12-19 15:00:00,251,135,116,Sonnig,6,6,0,
,2021-12-19 16:00:00,303,158,145,Sonnig,5,5,0,
,2021-12-19 17:00:00,228,99,129,Sonnig,4,4,0,
,2021-12-19 18:00:00,239,106,133,Sonnig,3,3,0,
,2021-12-19 19:00:00,183,94,89,Sonnig,1,1,0,
,2021-12-19 20:00:00,114,61,53,Sonnig,0,0,0,
,2021-12-19 21:00:00,82,33,49,Sonnig,-1,-1,0,
,2021-12-19 22:00:00,86,33,53,Sonnig,-1,-1,0,
,2021-12-19 23:00:00,60,20,40,Sonnig,-1,-1,0,
,2021-12-20 00:00:00,26,10,16,Sonnig,-1,-1,0,
,2021-12-20 01:00:00,14,11,3,Sonnig,-1,-1,0,
,2021-12-20 02:00:00,8,5,3,Leicht bewölkt,-1,-1,0,
,2021-12-20 03:00:00,5,1,4,Leicht bewölkt,-1,-1,0,
,2021-12-20 04:00:00,12,6,6,Leicht bewölkt,0,-1,0,
,2021-12-20 05:00:00,30,15,15,Leicht bewölkt,0,-1,0,
,2021-12-20 06:00:00,122,61,61,Leicht bewölkt,1,-1,0,
,2021-12-20 07:00:00,740,440,300,Leicht bewölkt,1,-1,0,
,2021-12-20 08:00:00,559,305,254,Bewölkt,1,-1,0,
,2021-12-20 09:00:00,529,353,176,Bewölkt,1,-1,0,
,2021-12-20 10:00:00,377,207,170,Bewölkt,2,0,0,
,2021-12-20 11:00:00,466,230,236,Leicht bewölkt,3,1,0,
,2021-12-20 12:00:00,524,235,289,Leicht bewölkt,4,1,0,
,2021-12-20 13:00:00,761,339,422,Leicht bewölkt,5,2,0,
,2021-12-20 14:00:00,574,288,286,Sonnig,6,3,0,
,2021-12-20 15:00:00,835,395,440,Sonnig,7,4,0,
,2021-12-20 16:00:00,709,346,363,Sonnig,5,2,0,
,2021-12-20 17:00:00,747,327,420,Sonnig,4,0,0,
,2021-12-20 18:00:00,562,254,308,Sonnig,2,-2,0,
,2021-12-20 19:00:00,422,203,219,Sonnig,1,-3,0,
,2021-12-20 20:00:00,263,111,152,Sonnig,0,-5,0,
,2021-12-20 21:00:00,142,74,68,Sonnig,-2,-6,0,
,2021-12-20 22:00:00,120,55,65,Sonnig,-2,-6,0,
,2021-12-20 23:00:00,85,37,48,Leicht bewölkt,-2,-6,0,
,2021-12-21 00:00:00,41,11,30,Leicht bewölkt,-2,-6,0,
,2021-12-21 01:00:00,38,8,30,Leicht bewölkt,-3,-6,0,
,2021-12-21 02:00:00,11,7,4,Sonnig,-3,-6,0,
,2021-12-21 03:00:00,4,1,3,Sonnig,-3,-6,0,
,2021-12-21 04:00:00,6,3,3,Sonnig,-3,-6,0,
,2021-12-21 05:00:00,36,25,11,Sonnig,-3,-6,0,
,2021-12-21 06:00:00,113,66,47,Sonnig,-3,-6,0,
,2021-12-21 07:00:00,713,462,251,Sonnig,-3,-5,0,
,2021-12-21 08:00:00,578,333,245,Leicht bewölkt,-3,-5,0,
,2021-12-21 09:00:00,566,359,207,Leicht bewölkt,-3,-5,0,
,2021-12-21 10:00:00,406,249,157,Leicht bewölkt,-2,-4,0,
,2021-12-21 11:00:00,562,268,294,Leicht bewölkt,-1,-3,0,
,2021-12-21 12:00:00,563,246,317,Leicht bewölkt,1,-2,0,
,2021-12-21 13:00:00,774,326,448,Leicht bewölkt,1,-1,0,
,2021-12-21 14:00:00,536,222,314,Sonnig,2,0,0,
,2021-12-21 15:00:00,742,339,403,Sonnig,2,1,0,
,2021-12-21 16:00:00,666,302,364,Sonnig,1,0,0,
,2021-12-21 17:00:00,720,304,416,Sonnig,1,-1,0,
,2021-12-21 18:00:00,606,287,319,Sonnig,0,-1,0,
,2021-12-21 19:00:00,380,148,232,Sonnig,-1,-2,0,
,2021-12-21 20:00:00,277,135,142,Sonnig,-3,-3,0,
,2021-12-21 21:00:00,157,70,87,Sonnig,-4,-4,0,
,2021-12-21 22:00:00,135,66,69,Sonnig,-4,-4,0,
,2021-12-21 23:00:00,84,33,51,Sonnig,-5,-5,0,
,2021-12-22 00:00:00,31,14,17,Sonnig,-5,-5,0,
,2021-12-22 01:00:00,45,12,33,Sonnig,-5,-5,0,
,2021-12-22 02:00:00,14,6,8,Sonnig,-5,-5,0,
,2021-12-22 03:00:00,12,6,6,Sonnig,-5,-5,0,
,2021-12-22 04:00:00,10,6,4,Sonnig,-6,-6,0,
,2021-12-22 05:00:00,34,20,14,Sonnig,-6,-6,0,
,2021-12-22 06:00:00,131,74,57,Sonnig,-6,-6,0,
,2021-12-22 07:00:00,647,388,259,Sonnig,-6,-6,0,
,2021-12-22 08:00:00,469,267,202,Sonnig,-5,-5,0,
,2021-12-22 09:00:00,494,297,197,Sonnig,-5,-5,0,
,2021-12-22 10:00:00,402,216,186,Sonnig,-3,-3,0,
,2021-12-22 11:00:00,488,241,247,Sonnig,-1,-1,0,
,2021-12-22 12:00:00,667,242,425,Sonnig,1,1,0,
,2021-12-22 13:00:00,591,310,281,Sonnig,1,1,0,
,2021-12-22 14:00:00,471,223,248,Leicht bewölkt,1,1,0,
,2021-12-22 15:00:00,521,246,275,Leicht bewölkt,2,2,0,
,2021-12-22 16:00:00,563,264,299,Leicht bewölkt,0,0,0,
,2021-12-22 17:00:00,523,246,277,Bedeckt,-2,-2,0,
,2021-12-22 18:00:00,442,152,290,Bedeckt,-3,-3,0,
,2021-12-22 19:00:00,320,149,171,Bedeckt,-4,-4,0,
,2021-12-22 20:00:00,214,95,119,Leicht bewölkt,-4,-4,0,
,2021-12-22 21:00:00,141,54,87,Leicht bewölkt,-5,-5,0,
,2021-12-22 22:00:00,104,40,64,Leicht bewölkt,-5,-5,0,
,2021-12-22 23:00:00,101,32,69,Leicht bewölkt,-5,-5,0,
,2021-12-23 00:00:00,51,17,34,Leicht bewölkt,-5,-5,0,
,2021-12-23 01:00:00,45,14,31,Leicht bewölkt,-5,-6,0,
,2021-12-23 02:00:00,14,7,7,Sonnig,-5,-6,0,
,2021-12-23 03:00:00,10,2,8,Sonnig,-5,-7,0,
,2021-12-23 04:00:00,18,11,7,Sonnig,-5,-7,0,
,2021-12-23 05:00:00,27,16,11,Leicht bewölkt,-5,-7,0,
,2021-12-23 06:00:00,91,57,34,Leicht bewölkt,-5,-7,0,
,2021-12-23 07:00:00,206,129,77,Leicht bewölkt,-5,-6,0,
,2021-12-23 08:00:00,269,161,108,Sonnig,-4,-6,0,
,2021-12-23 09:00:00,317,198,119,Sonnig,-4,-5,0,
,2021-12-23 10:00:00,295,182,113,Sonnig,-2,-3,0,
,2021-12-23 11:00:00,414,212,202,Bedeckt,0,-1,0,
,2021-12-23 12:00:00,411,184,227,Bedeckt,2,1,0,
,2021-12-23 13:00:00,433,208,225,Bedeckt,2,1,0,
,2021-12-23 14:00:00,478,253,225,Bedeckt,2,1,0,
,2021-12-23 15:00:00,472,245,227,Bedeckt,2,1,0,
,2021-12-23 16:00:00,465,196,269,Bedeckt,1,0,0,
,2021-12-23 17:00:00,378,162,216,Sonnig,0,-1,0,
,2021-12-23 18:00:00,292,122,170,Sonnig,-1,-2,0,
,2021-12-23 19:00:00,192,78,114,Sonnig,-1,-3,0,
,2021-12-23 20:00:00,160,64,96,Sonnig,-1,-3,0,
,2021-12-23 21:00:00,108,42,66,Sonnig,-2,-4,0,
,2021-12-23 22:00:00,64,24,40,Sonnig,-1,-4,0,
,2021-12-23 23:00:00,56,25,31,Leicht bewölkt,-1,-4,0,
,2021-12-24 00:00:00,47,17,30,Leicht bewölkt,-1,-4,0,
,2021-12-24 01:00:00,36,18,18,Leicht bewölkt,-1,-3,0,
,2021-12-24 02:00:00,17,8,9,Leicht bewölkt,-1,-3,0,
,2021-12-24 03:00:00,7,4,3,Leicht bewölkt,-1,-3,0,
,2021-12-24 04:00:00,4,1,3,Leicht bewölkt,-1,-3,0,
,2021-12-24 05:00:00,15,9,6,Leicht bewölkt,-1,-3,0,
,2021-12-24 06:00:00,44,33,11,Leicht bewölkt,-1,-3,0,
,2021-12-24 07:00:00,62,44,18,Leicht bewölkt,-1,-3,0,
,2021-12-24 08:00:00,183,110,73,Sonnig,-1,-3,0,
,2021-12-24 09:00:00,247,152,95,Sonnig,-1,-3,0,
,2021-12-24 10:00:00,315,164,151,Sonnig,1,-1,0,
,2021-12-24 11:00:00,294,125,169,Leicht bewölkt,3,1,0,
,2021-12-24 12:00:00,226,91,135,Leicht bewölkt,5,4,0,
,2021-12-24 13:00:00,235,94,141,Leicht bewölkt,5,3,0,
,2021-12-24 14:00:00,175,57,118,Bedeckt,4,3,0,
,2021-12-24 15:00:00,125,48,77,Bedeckt,4,3,0,
,2021-12-24 16:00:00,105,44,61,Bedeckt,4,3,0,
,2021-12-24 17:00:00,78,49,29,Bedeckt,4,3,0,
,2021-12-24 18:00:00,54,27,27,Bedeckt,3,2,0,
,2021-12-24 19:00:00,43,9,34,Bedeckt,3,2,0,
,2021-12-24 20:00:00,35,22,13,Stellenweiser Regenfall,3,2,0,
,2021-12-24 21:00:00,36,22,14,Stellenweiser Regenfall,3,2,0,
,2021-12-24 22:00:00,37,16,21,Stellenweiser Regenfall,3,1,0,
,2021-12-24 23:00:00,44,22,22,Stellenweiser Regenfall,3,1,0.2,
,2021-12-25 00:00:00,41,22,19,Stellenweiser Regenfall,3,1,0.4,
,2021-12-25 01:00:00,19,11,8,Stellenweiser Regenfall,3,1,0.2,
,2021-12-25 02:00:00,13,5,8,Leicht bewölkt,2,1,0,
,2021-12-25 03:00:00,9,3,6,Leicht bewölkt,2,1,0,
,2021-12-25 04:00:00,5,2,3,Leicht bewölkt,2,1,0,
,2021-12-25 05:00:00,9,5,4,Leicht bewölkt,2,1,0,
,2021-12-25 06:00:00,17,13,4,Leicht bewölkt,2,1,0,
,2021-12-25 07:00:00,17,6,11,Leicht bewölkt,2,1,0,
,2021-12-25 08:00:00,17,9,8,Bedeckt,2,1,0,
,2021-12-25 09:00:00,35,20,15,Bedeckt,2,1,0,
,2021-12-25 10:00:00,42,27,15,Bedeckt,3,2,0,
,2021-12-25 11:00:00,51,26,25,Bedeckt,4,4,0,
,2021-12-25 12:00:00,71,38,33,Bedeckt,6,6,0,
,2021-12-25 13:00:00,48,24,24,Bedeckt,6,6,0,
,2021-12-25 14:00:00,66,36,30,Bedeckt,6,6,0,
,2021-12-25 15:00:00,56,20,36,Bedeckt,6,6,0,
,2021-12-25 16:00:00,57,33,24,Bedeckt,5,5,0,
,2021-12-25 17:00:00,68,35,33,Leicht bewölkt,4,4,0,
,2021-12-25 18:00:00,59,30,29,Leicht bewölkt,4,4,0,
,2021-12-25 19:00:00,55,29,26,Leicht bewölkt,3,3,0,
,2021-12-25 20:00:00,44,21,23,Leicht bewölkt,3,3,0,
,2021-12-25 21:00:00,38,19,19,Leicht bewölkt,3,2,0,
,2021-12-25 22:00:00,47,19,28,Leicht bewölkt,3,3,0,
,2021-12-25 23:00:00,35,15,20,Bedeckt,4,4,0,
,2021-12-26 00:00:00,18,10,8,Bedeckt,5,5,0,
,2021-12-26 01:00:00,7,2,5,Bedeckt,5,5,0,
,2021-12-26 02:00:00,8,5,3,Bewölkt,4,4,0,
,2021-12-26 03:00:00,13,4,9,Bewölkt,4,4,0,
,2021-12-26 04:00:00,6,3,3,Bewölkt,4,4,0,
,2021-12-26 05:00:00,9,7,2,Bewölkt,4,4,0,
,2021-12-26 06:00:00,18,6,12,Bewölkt,4,3,0,
,2021-12-26 07:00:00,11,6,5,Bewölkt,4,4,0,
,2021-12-26 08:00:00,14,7,7,Bewölkt,4,4,0,
,2021-12-26 09:00:00,51,29,22,Bewölkt,5,4,0,
,2021-12-26 10:00:00,44,27,17,Bewölkt,6,5,0,
,2021-12-26 11:00:00,58,29,29,Bewölkt,7,6,0,
,2021-12-26 12:00:00,105,51,54,Bewölkt,8,8,0,
,2021-12-26 13:00:00,93,45,48,Bewölkt,8,8,0,
,2021-12-26 14:00:00,115,54,61,Bewölkt,8,8,0,
,2021-12-26 15:00:00,92,45,47,Bewölkt,8,8,0,
,2021-12-26 16:00:00,99,47,52,Bewölkt,7,7,0,
,2021-12-26 17:00:00,70,30,40,Bedeckt,6,6,0,
,2021-12-26 18:00:00,58,30,28,Bedeckt,6,5,0,
,2021-12-26 19:00:00,48,21,27,Bedeckt,6,5,0,
,2021-12-26 20:00:00,62,34,28,Nieselregen,5,5,0.1,
,2021-12-26 21:00:00,47,22,25,Nieselregen,5,5,0.1,
,2021-12-26 22:00:00,27,14,13,Nieselregen,5,4,0,
,2021-12-26 23:00:00,23,15,8,Nieselregen,5,4,0.2,
,2021-12-27 00:00:00,23,8,15,Nieselregen,6,4,0.4,
,2021-12-27 01:00:00,13,6,7,Nieselregen,5,4,0.2,
,2021-12-27 02:00:00,7,3,4,Leicht bewölkt,5,4,0,
,2021-12-27 03:00:00,7,3,4,Leicht bewölkt,5,4,0,
,2021-12-27 04:00:00,8,3,5,Leicht bewölkt,4,2,0,
,2021-12-27 05:00:00,31,19,12,Leicht bewölkt,3,1,0,
,2021-12-27 06:00:00,47,30,17,Leicht bewölkt,2,0,0,
,2021-12-27 07:00:00,92,53,39,Leicht bewölkt,2,1,0,
,2021-12-27 08:00:00,124,74,50,Sonnig,2,1,0,
,2021-12-27 09:00:00,163,105,58,Sonnig,2,1,0,
,2021-12-27 10:00:00,232,129,103,Sonnig,4,3,0,
,2021-12-27 11:00:00,263,163,100,Bedeckt,5,5,0,
,2021-12-27 12:00:00,287,129,158,Bedeckt,7,7,0,
,2021-12-27 13:00:00,263,118,145,Bedeckt,7,6,0,
,2021-12-27 14:00:00,297,141,156,Bedeckt,6,6,0,
,2021-12-27 15:00:00,272,120,152,Bedeckt,6,5,0,
,2021-12-27 16:00:00,272,134,138,Bedeckt,5,5,0,
,2021-12-27 17:00:00,273,122,151,Bedeckt,5,4,0,
,2021-12-27 18:00:00,204,67,137,Bedeckt,4,3,0,
,2021-12-27 19:00:00,136,60,76,Bedeckt,4,3,0,
,2021-12-27 20:00:00,107,43,64,Leichter Regenfall,4,3,0.3,
,2021-12-27 21:00:00,59,23,36,Leichter Regenfall,4,3,0.4,
,2021-12-27 22:00:00,59,25,34,Leichter Regenfall,4,3,0.2,
,2021-12-27 23:00:00,35,17,18,Stellenweiser Regenfall,4,2,0.1,
,2021-12-28 00:00:00,35,13,22,Stellenweiser Regenfall,4,2,0.1,
,2021-12-28 01:00:00,18,7,11,Stellenweiser Regenfall,3,2,0.1,
,2021-12-28 02:00:00,5,3,2,Sonnig,2,1,0,
,2021-12-28 03:00:00,6,4,2,Sonnig,2,0,0,
,2021-12-28 04:00:00,9,4,5,Sonnig,2,1,0,
,2021-12-28 05:00:00,19,9,10,Bedeckt,2,1,0,
,2021-12-28 06:00:00,50,36,14,Bedeckt,2,1,0,
,2021-12-28 07:00:00,74,42,32,Bedeckt,2,1,0,
,2021-12-28 08:00:00,136,85,51,Stellenweiser Regenfall,2,1,0,
,2021-12-28 09:00:00,170,105,65,Stellenweiser Regenfall,3,1,0,
,2021-12-28 10:00:00,223,146,77,Stellenweiser Regenfall,4,2,0,
,2021-12-28 11:00:00,290,152,138,Nieselregen,5,3,0.1,
,2021-12-28 12:00:00,221,94,127,Nieselregen,7,4,0.2,
,2021-12-28 13:00:00,237,122,115,Nieselregen,8,5,0.1,
,2021-12-28 14:00:00,204,67,137,Bedeckt,9,6,0,
,2021-12-28 15:00:00,188,78,110,Bedeckt,9,7,0,
,2021-12-28 16:00:00,208,106,102,Bedeckt,9,6,0,
,2021-12-28 17:00:00,189,92,97,Nieselregen,9,6,0.2,
,2021-12-28 18:00:00,149,70,79,Nieselregen,8,5,0.2,
,2021-12-28 19:00:00,119,51,68,Nieselregen,8,5,0.1,
,2021-12-28 20:00:00,116,44,72,Bedeckt,8,5,0,
,2021-12-28 21:00:00,71,28,43,Bedeckt,8,5,0,
,2021-12-28 22:00:00,50,21,29,Bedeckt,8,5,0,
,2021-12-28 23:00:00,41,18,23,Leichter Regenschauer,9,5,0.3,
,2021-12-29 00:00:00,32,11,21,Leichter Regenschauer,9,6,0.5,
,2021-12-29 01:00:00,14,6,8,Leichter Regenschauer,9,5,0.3,
,2021-12-29 02:00:00,9,5,4,Stellenweiser Regenfall,9,5,0,
,2021-12-29 03:00:00,9,2,7,Stellenweiser Regenfall,8,5,0,
,2021-12-29 04:00:00,9,7,2,Stellenweiser Regenfall,8,5,0,
,2021-12-29 05:00:00,25,16,9,Leicht bewölkt,8,4,0,
,2021-12-29 06:00:00,51,34,17,Leicht bewölkt,8,4,0,
,2021-12-29 07:00:00,95,55,40,Leicht bewölkt,7,4,0,
,2021-12-29 08:00:00,124,75,49,Leichter Regenfall,6,3,0.5,
,2021-12-29 09:00:00,202,135,67,Leichter Regenfall,6,3,0.6,
,2021-12-29 10:00:00,227,141,86,Leichter Regenfall,6,3,0.3,
,2021-12-29 11:00:00,261,121,140,Leichter Regenfall,6,3,0.6,
,2021-12-29 12:00:00,270,127,143,Leichter Regenfall,6,3,0.8,
,2021-12-29 13:00:00,231,88,143,Leichter Regenfall,7,4,0.4,
,2021-12-29 14:00:00,226,113,113,Bedeckt,9,6,0,
,2021-12-29 15:00:00,186,92,94,Bedeckt,10,8,0,
,2021-12-29 16:00:00,212,103,109,Bedeckt,10,7,0,
,2021-12-29 17:00:00,220,84,136,Leichter Regenfall,10,7,0.3,
,2021-12-29 18:00:00,188,71,117,Leichter Regenfall,10,7,0.4,
,2021-12-29 19:00:00,141,59,82,Leichter Regenfall,10,8,0.2,
,2021-12-29 20:00:00,115,45,70,Bedeckt,11,8,0,
,2021-12-29 21:00:00,76,38,38,Bedeckt,11,9,0,
,2021-12-29 22:00:00,68,33,35,Bedeckt,11,9,0,
,2021-12-29 23:00:00,50,18,32,Leichter Regenschauer,11,8,0.3,
,2021-12-30 00:00:00,29,11,18,Leichter Regenschauer,11,8,0.6,
,2021-12-30 01:00:00,35,12,23,Leichter Regenschauer,11,8,0.3,
,2021-12-30 02:00:00,7,3,4,Nieselregen,11,8,0.1,
,2021-12-30 03:00:00,15,8,7,Nieselregen,11,8,0.1,
,2021-12-30 04:00:00,3,2,1,Nieselregen,11,8,0,
,2021-12-30 05:00:00,30,14,16,Leichter Regenschauer,11,9,0.1,
,2021-12-30 06:00:00,53,31,22,Leichter Regenschauer,11,9,0.1,
,2021-12-30 07:00:00,96,53,43,Leichter Regenschauer,11,9,0.1,
,2021-12-30 08:00:00,135,86,49,Stellenweiser Regenfall,11,9,0,
,2021-12-30 09:00:00,174,110,64,Stellenweiser Regenfall,11,9,0,
,2021-12-30 10:00:00,259,158,101,Stellenweiser Regenfall,11,10,0,
,2021-12-30 11:00:00,323,175,148,Bedeckt,11,10,0,
,2021-12-30 12:00:00,340,166,174,Bedeckt,11,11,0,
,2021-12-30 13:00:00,372,188,184,Bedeckt,11,11,0,
,2021-12-30 14:00:00,403,199,204,Bedeckt,11,11,0,
,2021-12-30 15:00:00,418,191,227,Bedeckt,11,11,0,
,2021-12-30 16:00:00,391,178,213,Bedeckt,11,10,0,
,2021-12-30 17:00:00,391,158,233,Bedeckt,10,9,0,
,2021-12-30 18:00:00,303,137,166,Bedeckt,10,9,0,
,2021-12-30 19:00:00,166,68,98,Bedeckt,9,8,0,
,2021-12-30 20:00:00,168,73,95,Leicht bewölkt,8,7,0,
,2021-12-30 21:00:00,104,37,67,Leicht bewölkt,8,6,0,
,2021-12-30 22:00:00,76,32,44,Leicht bewölkt,8,7,0,
,2021-12-30 23:00:00,50,15,35,Leicht bewölkt,8,7,0,
,2021-12-31 00:00:00,37,20,17,Leicht bewölkt,8,8,0,
,2021-12-31 01:00:00,26,13,13,Leicht bewölkt,8,7,0,
,2021-12-31 02:00:00,6,4,2,Leicht bewölkt,7,6,0,
,2021-12-31 03:00:00,6,2,4,Leicht bewölkt,6,6,0,
,2021-12-31 04:00:00,9,6,3,Leicht bewölkt,6,5,0,
,2021-12-31 05:00:00,19,10,9,Sonnig,5,5,0,
,2021-12-31 06:00:00,34,24,10,Sonnig,5,4,0,
,2021-12-31 07:00:00,66,41,25,Sonnig,4,4,0,
,2021-12-31 08:00:00,139,93,46,Sonnig,4,4,0,
,2021-12-31 09:00:00,236,144,92,Sonnig,4,4,0,
,2021-12-31 10:00:00,353,192,161,Sonnig,7,7,0,
,2021-12-31 11:00:00,395,192,203,Sonnig,9,9,0,
,2021-12-31 12:00:00,389,157,232,Sonnig,12,12,0,
,2021-12-31 13:00:00,338,145,193,Sonnig,12,12,0,
,2021-12-31 14:00:00,301,139,162,Sonnig,12,13,0,
,2021-12-31 15:00:00,327,150,177,Sonnig,12,13,0,
,2021-12-31 16:00:00,284,122,162,Sonnig,11,11,0,
,2021-12-31 17:00:00,271,132,139,Sonnig,9,10,0,
,2021-12-31 18:00:00,247,143,104,Sonnig,8,8,0,
,2021-12-31 19:00:00,196,104,92,Sonnig,7,7,0,
,2021-12-31 20:00:00,111,52,59,Sonnig,6,5,0,
,2021-12-31 21:00:00,88,59,29,Sonnig,5,4,0,
,2021-12-31 22:00:00,74,42,32,Sonnig,5,4,0,
,2021-12-31 23:00:00,77,37,40,Sonnig,5,4,0,
